,행정기관코드,행정기관,총인구수,세대수,세대당 인구,남자 인구수,여자 인구수,남여 비율
0,1100000000,서울특별시,9509458,4426007,2.15,4618040,4891418,0.94
1,1111000000,서울특별시종로구,144683,73494,1.97,70183,74500,0.94
2,1111051500,서울특별시종로구청운효자동,11978,5241,2.29,5526,6452,0.86
3,1111053000,서울특별시종로구사직동,9372,4696,2.0,4200,5172,0.81
4,1111054000,서울특별시종로구삼청동,2456,1229,2.0,1168,1288,0.91
5,1111055000,서울특별시종로구부암동,9579,4265,2.25,4570,5009,0.91
6,1111056000,서울특별시종로구평창동,18152,7509,2.42,8457,9695,0.87
7,1111057000,서울특별시종로구무악동,8259,3069,2.69,3841,4418,0.87
8,1111058000,서울특별시종로구교남동,10046,4458,2.25,4634,5412,0.86
9,1111060000,서울특별시종로구가회동,4088,1991,2.05,1884,2204,0.85
10,1111061500,서울특별시종로구종로1.2.3.4가동,7197,5247,1.37,4251,2946,1.44
11,1111063000,서울특별시종로구종로5.6가동,5089,3385,1.5,2720,2369,1.15
12,1111064000,서울특별시종로구이화동,7231,4298,1.68,3419,3812,0.9
13,1111065000,서울특별시종로구혜화동,16383,9187,1.78,7904,8479,0.93
14,1111067000,서울특별시종로구창신제1동,4891,2823,1.73,2626,2265,1.16
15,1111068000,서울특별시종로구창신제2동,7911,4043,1.96,4082,3829,1.07
16,1111069000,서울특별시종로구창신제3동,6575,2798,2.35,3242,3333,0.97
17,1111070000,서울특별시종로구숭인제1동,5837,2970,1.97,2811,3026,0.93
18,1111071000,서울특별시종로구숭인제2동,9639,6285,1.53,4848,4791,1.01
19,1114000000,서울특별시중구,122499,63519,1.93,59630,62869,0.95
20,1114052000,서울특별시중구소공동,2250,1296,1.74,1077,1173,0.92
21,1114054000,서울특별시중구회현동,4784,2748,1.74,2488,2296,1.08
22,1114055000,서울특별시중구명동,2884,1539,1.87,1262,1622,0.78
23,1114057000,서울특별시중구필동,4023,2479,1.62,2045,1978,1.03
24,1114058000,서울특별시중구장충동,4590,2750,1.67,2351,2239,1.05
25,1114059000,서울특별시중구광희동,5255,3390,1.55,2688,2567,1.05
26,1114060500,서울특별시중구을지로동,1738,1345,1.29,1048,690,1.52
27,1114061500,서울특별시중구신당동,7673,4729,1.62,3782,3891,0.97
28,1114062500,서울특별시중구다산동,13798,6886,2.0,6712,7086,0.95
29,1114063500,서울특별시중구약수동,16676,7834,2.13,7750,8926,0.87
30,1114064500,서울특별시중구청구동,13588,6287,2.16,6438,7150,0.9
31,1114065000,서울특별시중구신당제5동,10363,5387,1.92,5051,5312,0.95
32,1114066500,서울특별시중구동화동,10266,4090,2.51,4956,5310,0.93
33,1114067000,서울특별시중구황학동,12576,7088,1.77,5997,6579,0.91
34,1114068000,서울특별시중구중림동,12035,5671,2.12,5985,6050,0.99
35,1117000000,서울특별시용산구,222953,111036,2.01,107210,115743,0.93
36,1117051000,서울특별시용산구후암동,16833,8465,1.99,8211,8622,0.95
37,1117052000,서울특별시용산구용산2가동,9456,5247,1.8,4569,4887,0.93
38,1117053000,서울특별시용산구남영동,7351,5189,1.42,4471,2880,1.55
39,1117055500,서울특별시용산구청파동,19471,11080,1.76,9114,10357,0.88
40,1117056000,서울특별시용산구원효로제1동,15950,8105,1.97,7582,8368,0.91
41,1117057000,서울특별시용산구원효로제2동,13751,5985,2.3,6478,7273,0.89
42,1117058000,서울특별시용산구효창동,10037,4375,2.29,4748,5289,0.9
43,1117059000,서울특별시용산구용문동,11863,5377,2.21,5675,6188,0.92
44,1117062500,서울특별시용산구한강로동,21763,11713,1.86,10334,11429,0.9
45,1117063000,서울특별시용산구이촌제1동,25893,9542,2.71,12119,13774,0.88
46,1117064000,서울특별시용산구이촌제2동,8303,3693,2.25,3889,4414,0.88
47,1117065000,서울특별시용산구이태원제1동,6392,3628,1.76,3110,3282,0.95
48,1117066000,서울특별시용산구이태원제2동,8997,4918,1.83,4137,4860,0.85
49,1117068500,서울특별시용산구한남동,20389,10970,1.86,9841,10548,0.93
50,1117069000,서울특별시용산구서빙고동,13051,5322,2.45,6241,6810,0.92
51,1117070000,서울특별시용산구보광동,13453,7427,1.81,6691,6762,0.99
52,1120000000,서울특별시성동구,285990,134233,2.13,139380,146610,0.95
53,1120052000,서울특별시성동구왕십리제2동,16475,7411,2.22,7964,8511,0.94
54,1120053500,서울특별시성동구왕십리도선동,26430,11867,2.23,12552,13878,0.9
55,1120054000,서울특별시성동구마장동,22362,10968,2.04,11039,11323,0.97
56,1120055000,서울특별시성동구사근동,11915,7945,1.5,6154,5761,1.07
57,1120056000,서울특별시성동구행당제1동,13904,6468,2.15,6688,7216,0.93
58,1120057000,서울특별시성동구행당제2동,23280,9220,2.52,10907,12373,0.88
59,1120058000,서울특별시성동구응봉동,15408,6063,2.54,7352,8056,0.91
60,1120059000,서울특별시성동구금호1가동,15240,6552,2.33,7260,7980,0.91
61,1120061500,서울특별시성동구금호2.3가동,22735,10118,2.25,10824,11911,0.91
62,1120062000,서울특별시성동구금호4가동,14325,6370,2.25,6803,7522,0.9
63,1120064500,서울특별시성동구옥수동,26033,10900,2.39,12119,13914,0.87
64,1120065000,서울특별시성동구성수1가제1동,16514,7784,2.12,8249,8265,1.0
65,1120066000,서울특별시성동구성수1가제2동,12643,6175,2.05,6201,6442,0.96
66,1120067000,서울특별시성동구성수2가제1동,15806,8163,1.94,8263,7543,1.1
67,1120069000,서울특별시성동구성수2가제3동,10757,5554,1.94,5407,5350,1.01
68,1120072000,서울특별시성동구송정동,10516,5600,1.88,5551,4965,1.12
69,1120079000,서울특별시성동구용답동,11647,7075,1.65,6047,5600,1.08
70,1121500000,서울특별시광진구,339996,167949,2.02,164058,175938,0.93
71,1121571000,서울특별시광진구화양동,23138,17777,1.3,11037,12101,0.91
72,1121573000,서울특별시광진구군자동,19591,11323,1.73,9689,9902,0.98
73,1121574000,서울특별시광진구중곡제1동,15496,8378,1.85,7510,7986,0.94
74,1121575000,서울특별시광진구중곡제2동,21428,10645,2.01,10105,11323,0.89
75,1121576000,서울특별시광진구중곡제3동,16135,8461,1.91,7995,8140,0.98
76,1121577000,서울특별시광진구중곡제4동,28577,13174,2.17,13991,14586,0.96
77,1121578000,서울특별시광진구능동,11301,6401,1.77,5211,6090,0.86
78,1121581000,서울특별시광진구광장동,34665,11910,2.91,16787,17878,0.94
79,1121582000,서울특별시광진구자양제1동,22285,11911,1.87,10822,11463,0.94
80,1121583000,서울특별시광진구자양제2동,24632,11014,2.24,11937,12695,0.94
81,1121584000,서울특별시광진구자양제3동,28073,11093,2.53,13418,14655,0.92
82,1121584700,서울특별시광진구자양제4동,17957,9959,1.8,8942,9015,0.99
83,1121585000,서울특별시광진구구의제1동,21542,12154,1.77,10254,11288,0.91
84,1121586000,서울특별시광진구구의제2동,26522,11593,2.29,12797,13725,0.93
85,1121587000,서울특별시광진구구의제3동,28654,12156,2.36,13563,15091,0.9
86,1123000000,서울특별시동대문구,337400,168219,2.01,166646,170754,0.98
87,1123053600,서울특별시동대문구용신동,31619,18938,1.67,15897,15722,1.01
88,1123054500,서울특별시동대문구제기동,24617,13423,1.83,12612,12005,1.05
89,1123056000,서울특별시동대문구전농제1동,29198,14863,1.96,14627,14571,1.0
90,1123057000,서울특별시동대문구전농제2동,18557,7642,2.43,8935,9622,0.93
91,1123060000,서울특별시동대문구답십리제1동,28991,13089,2.21,13984,15007,0.93
92,1123061000,서울특별시동대문구답십리제2동,28334,12656,2.24,13781,14553,0.95
93,1123065000,서울특별시동대문구장안제1동,38241,18428,2.08,18930,19311,0.98
94,1123066000,서울특별시동대문구장안제2동,32484,14056,2.31,16210,16274,1.0
95,1123070500,서울특별시동대문구청량리동,18813,9675,1.94,9343,9470,0.99
96,1123071000,서울특별시동대문구회기동,10498,6549,1.6,5000,5498,0.91
97,1123072000,서울특별시동대문구휘경제1동,13927,7624,1.83,6633,7294,0.91
98,1123073000,서울특별시동대문구휘경제2동,24115,12114,1.99,12043,12072,1.0
99,1123074000,서울특별시동대문구이문제1동,18019,10418,1.73,8993,9026,1.0
100,1123075000,서울특별시동대문구이문제2동,19987,8744,2.29,9658,10329,0.94
101,1126000000,서울특별시중랑구,387350,185712,2.09,191112,196238,0.97
102,1126052000,서울특별시중랑구면목제2동,24049,12180,1.97,12000,12049,1.0
103,1126054000,서울특별시중랑구면목제4동,19029,9137,2.08,9470,9559,0.99
104,1126055000,서울특별시중랑구면목제5동,14784,6439,2.3,7421,7363,1.01
105,1126056500,서울특별시중랑구면목본동,33478,17660,1.9,16582,16896,0.98
106,1126057000,서울특별시중랑구면목제7동,21756,10600,2.05,10934,10822,1.01
107,1126057500,서울특별시중랑구면목제3.8동,24759,12668,1.95,12272,12487,0.98
108,1126058000,서울특별시중랑구상봉제1동,24046,10266,2.34,11714,12332,0.95
109,1126059000,서울특별시중랑구상봉제2동,20341,12269,1.66,9801,10540,0.93
110,1126060000,서울특별시중랑구중화제1동,19611,9085,2.16,9624,9987,0.96
111,1126061000,서울특별시중랑구중화제2동,24875,13631,1.82,12781,12094,1.06
112,1126062000,서울특별시중랑구묵제1동,34443,14854,2.32,16639,17804,0.93
113,1126063000,서울특별시중랑구묵제2동,18718,9259,2.02,9173,9545,0.96
114,1126065500,서울특별시중랑구망우본동,32155,15689,2.05,16110,16045,1.0
115,1126066000,서울특별시중랑구망우제3동,16359,8238,1.99,8204,8155,1.01
116,1126068000,서울특별시중랑구신내1동,38512,14704,2.62,18652,19860,0.94
117,1126069000,서울특별시중랑구신내2동,20435,9033,2.26,9735,10700,0.91
118,1129000000,서울특별시성북구,430528,195017,2.21,207578,222950,0.93
119,1129052500,서울특별시성북구성북동,16522,8225,2.01,7715,8807,0.88
120,1129055500,서울특별시성북구삼선동,22871,11531,1.98,10915,11956,0.91
121,1129057500,서울특별시성북구동선동,15480,9534,1.62,6509,8971,0.73
122,1129058000,서울특별시성북구돈암제1동,14687,6114,2.4,6869,7818,0.88
123,1129059000,서울특별시성북구돈암제2동,23825,8594,2.77,11285,12540,0.9
124,1129060000,서울특별시성북구안암동,14936,9385,1.59,7502,7434,1.01
125,1129061000,서울특별시성북구보문동,15416,7739,1.99,7449,7967,0.93
126,1129062000,서울특별시성북구정릉제1동,18178,7369,2.47,8729,9449,0.92
127,1129063000,서울특별시성북구정릉제2동,23048,9902,2.33,11130,11918,0.93
128,1129064000,서울특별시성북구정릉제3동,15046,7879,1.91,7491,7555,0.99
129,1129065000,서울특별시성북구정릉제4동,24873,10860,2.29,11992,12881,0.93
130,1129066000,서울특별시성북구길음제1동,35462,12519,2.83,16848,18614,0.91
131,1129068500,서울특별시성북구길음제2동,16653,6905,2.41,7977,8676,0.92
132,1129070500,서울특별시성북구종암동,38809,17149,2.26,19250,19559,0.98
133,1129071500,서울특별시성북구월곡제1동,26335,10854,2.43,12719,13616,0.93
134,1129072500,서울특별시성북구월곡제2동,19442,9617,2.02,9355,10087,0.93
135,1129076000,서울특별시성북구장위제1동,24315,10777,2.26,11911,12404,0.96
136,1129077000,서울특별시성북구장위제2동,13740,6716,2.05,6781,6959,0.97
137,1129078000,서울특별시성북구장위제3동,15855,6499,2.44,7809,8046,0.97
138,1129081000,서울특별시성북구석관동,35035,16849,2.08,17342,17693,0.98
139,1130500000,서울특별시강북구,299182,144536,2.07,145705,153477,0.95
140,1130553400,서울특별시강북구삼양동,23629,11126,2.12,11783,11846,0.99
141,1130553500,서울특별시강북구미아동,21504,11687,1.84,10342,11162,0.93
142,1130554500,서울특별시강북구송중동,29478,13975,2.11,14165,15313,0.93
143,1130555500,서울특별시강북구송천동,26380,13549,1.95,13093,13287,0.99
144,1130557500,서울특별시강북구삼각산동,31361,11577,2.71,15054,16307,0.92
145,1130559500,서울특별시강북구번1동,18353,10279,1.79,9271,9082,1.02
146,1130560300,서울특별시강북구번2동,15847,7597,2.09,7664,8183,0.94
147,1130560800,서울특별시강북구번3동,16846,7478,2.25,7893,8953,0.88
148,1130561500,서울특별시강북구수유1동,20639,10419,1.98,10195,10444,0.98
149,1130562500,서울특별시강북구수유2동,21278,9866,2.16,10174,11104,0.92
150,1130563500,서울특별시강북구수유3동,22983,12921,1.78,11464,11519,1.0
151,1130564500,서울특별시강북구우이동,20542,9613,2.14,9935,10607,0.94
152,1130566000,서울특별시강북구인수동,30342,14449,2.1,14672,15670,0.94
153,1132000000,서울특별시도봉구,317366,138656,2.29,154487,162879,0.95
154,1132051100,서울특별시도봉구창제1동,24706,10957,2.25,11732,12974,0.9
155,1132051200,서울특별시도봉구창제2동,29099,12613,2.31,14173,14926,0.95
156,1132051300,서울특별시도봉구창제3동,13836,6544,2.11,6920,6916,1.0
157,1132051400,서울특별시도봉구창제4동,26496,10699,2.48,12755,13741,0.93
158,1132051500,서울특별시도봉구창제5동,24607,10245,2.4,11750,12857,0.91
159,1132052100,서울특별시도봉구도봉제1동,21072,10385,2.03,10632,10440,1.02
160,1132052200,서울특별시도봉구도봉제2동,26837,11875,2.26,13106,13731,0.95
161,1132066000,서울특별시도봉구쌍문제1동,21380,9407,2.27,10313,11067,0.93
162,1132067000,서울특별시도봉구쌍문제2동,18728,8594,2.18,8952,9776,0.92
163,1132068000,서울특별시도봉구쌍문제3동,16614,7890,2.11,8058,8556,0.94
164,1132068100,서울특별시도봉구쌍문제4동,18606,7099,2.62,8797,9809,0.9
165,1132069000,서울특별시도봉구방학제1동,28673,12938,2.22,14234,14439,0.99
166,1132070000,서울특별시도봉구방학제2동,19669,9418,2.09,9926,9743,1.02
167,1132071000,서울특별시도봉구방학제3동,27043,9992,2.71,13139,13904,0.94
168,1135000000,서울특별시노원구,510956,217378,2.35,246053,264903,0.93
169,1135056000,서울특별시노원구월계1동,21602,10228,2.11,11149,10453,1.07
170,1135057000,서울특별시노원구월계2동,26568,11944,2.22,12794,13774,0.93
171,1135058000,서울특별시노원구월계3동,29885,12991,2.3,14266,15619,0.91
172,1135059500,서울특별시노원구공릉1동,36610,18190,2.01,17849,18761,0.95
173,1135060000,서울특별시노원구공릉2동,40374,17045,2.37,19690,20684,0.95
174,1135061100,서울특별시노원구하계1동,26562,11491,2.31,12728,13834,0.92
175,1135061200,서울특별시노원구하계2동,21977,8211,2.68,10476,11501,0.91
176,1135061900,서울특별시노원구중계본동,23955,8383,2.86,11659,12296,0.95
177,1135062100,서울특별시노원구중계1동,26778,8956,2.99,13002,13776,0.94
178,1135062400,서울특별시노원구중계4동,19928,8343,2.39,9584,10344,0.93
179,1135062500,서울특별시노원구중계2.3동,34196,15269,2.24,15690,18506,0.85
180,1135063000,서울특별시노원구상계1동,38126,15601,2.44,18451,19675,0.94
181,1135064000,서울특별시노원구상계2동,19980,8657,2.31,9889,10091,0.98
182,1135066500,서울특별시노원구상계3.4동,26166,11999,2.18,13003,13163,0.99
183,1135067000,서울특별시노원구상계5동,23940,10926,2.19,11607,12333,0.94
184,1135069500,서울특별시노원구상계6.7동,32641,13894,2.35,15088,17553,0.86
185,1135070000,서울특별시노원구상계8동,22547,9219,2.45,10816,11731,0.92
186,1135071000,서울특별시노원구상계9동,20444,8378,2.44,9656,10788,0.9
187,1135072000,서울특별시노원구상계10동,18677,7653,2.44,8656,10021,0.86
188,1138000000,서울특별시은평구,473307,214711,2.2,226458,246849,0.92
189,1138051000,서울특별시은평구녹번동,36807,17601,2.09,17434,19373,0.9
190,1138052000,서울특별시은평구불광제1동,38518,17756,2.17,18167,20351,0.89
191,1138053000,서울특별시은평구불광제2동,27545,13989,1.97,13330,14215,0.94
192,1138055100,서울특별시은평구갈현제1동,21876,10787,2.03,10672,11204,0.95
193,1138055200,서울특별시은평구갈현제2동,28240,12650,2.23,13379,14861,0.9
194,1138056000,서울특별시은평구구산동,32207,13325,2.42,15777,16430,0.96
195,1138057000,서울특별시은평구대조동,26881,14546,1.85,12497,14384,0.87
196,1138058000,서울특별시은평구응암제1동,32960,14952,2.2,15617,17343,0.9
197,1138059000,서울특별시은평구응암제2동,27912,11263,2.48,13547,14365,0.94
198,1138060000,서울특별시은평구응암제3동,24336,12494,1.95,11854,12482,0.95
199,1138062500,서울특별시은평구역촌동,45384,20822,2.18,21321,24063,0.89
200,1138063100,서울특별시은평구신사제1동,27031,11896,2.27,13035,13996,0.93
201,1138063200,서울특별시은평구신사제2동,20211,8976,2.25,10097,10114,1.0
202,1138064000,서울특별시은평구증산동,14909,6768,2.2,7273,7636,0.95
203,1138065000,서울특별시은평구수색동,12692,5360,2.37,6254,6438,0.97
204,1138069000,서울특별시은평구진관동,55798,21526,2.59,26204,29594,0.89
205,1141000000,서울특별시서대문구,304819,143647,2.12,145694,159125,0.92
206,1141052000,서울특별시서대문구천연동,17121,7749,2.21,8121,9000,0.9
207,1141055500,서울특별시서대문구북아현동,15930,7209,2.21,7644,8286,0.92
208,1141056500,서울특별시서대문구충현동,20355,10263,1.98,9807,10548,0.93
209,1141058500,서울특별시서대문구신촌동,19752,14010,1.41,8756,10996,0.8
210,1141061500,서울특별시서대문구연희동,34976,18600,1.88,16737,18239,0.92
211,1141062000,서울특별시서대문구홍제제1동,23676,10409,2.27,11090,12586,0.88
212,1141064000,서울특별시서대문구홍제제3동,15336,7046,2.18,7410,7926,0.93
213,1141065500,서울특별시서대문구홍제제2동,13703,5805,2.36,6471,7232,0.89
214,1141066000,서울특별시서대문구홍은제1동,22697,9731,2.33,10957,11740,0.93
215,1141068500,서울특별시서대문구홍은제2동,26496,12316,2.15,12796,13700,0.93
216,1141069000,서울특별시서대문구남가좌제1동,15409,5673,2.72,7384,8025,0.92
217,1141070000,서울특별시서대문구남가좌제2동,29780,13344,2.23,14416,15364,0.94
218,1141071000,서울특별시서대문구북가좌제1동,18009,6908,2.61,8676,9333,0.93
219,1141072000,서울특별시서대문구북가좌제2동,31579,14584,2.17,15429,16150,0.96
220,1144000000,서울특별시마포구,368905,179861,2.05,173504,195401,0.89
221,1144055500,서울특별시마포구아현동,25233,10423,2.42,11832,13401,0.88
222,1144056500,서울특별시마포구공덕동,37164,18507,2.01,17460,19704,0.89
223,1144058500,서울특별시마포구도화동,21151,9305,2.27,10091,11060,0.91
224,1144059000,서울특별시마포구용강동,21619,9393,2.3,10236,11383,0.9
225,1144060000,서울특별시마포구대흥동,14517,8673,1.67,7023,7494,0.94
226,1144061000,서울특별시마포구염리동,16817,7754,2.17,8093,8724,0.93
227,1144063000,서울특별시마포구신수동,22489,9976,2.25,10954,11535,0.95
228,1144065500,서울특별시마포구서강동,24938,12165,2.05,11863,13075,0.91
229,1144066000,서울특별시마포구서교동,24826,15381,1.61,11383,13443,0.85
230,1144068000,서울특별시마포구합정동,17311,9508,1.82,8022,9289,0.86
231,1144069000,서울특별시마포구망원제1동,20041,10325,1.94,9378,10663,0.88
232,1144070000,서울특별시마포구망원제2동,18567,8464,2.19,8725,9842,0.89
233,1144071000,서울특별시마포구연남동,14914,8641,1.73,7052,7862,0.9
234,1144072000,서울특별시마포구성산제1동,18930,9398,2.01,8912,10018,0.89
235,1144073000,서울특별시마포구성산제2동,39608,19231,2.06,17886,21722,0.82
236,1144074000,서울특별시마포구상암동,30780,12717,2.42,14594,16186,0.9
237,1147000000,서울특별시양천구,447302,181404,2.47,219214,228088,0.96
238,1147051000,서울특별시양천구목1동,30750,10403,2.96,14773,15977,0.92
239,1147052000,서울특별시양천구목2동,29903,13396,2.23,14562,15341,0.95
240,1147053000,서울특별시양천구목3동,21815,10027,2.18,10408,11407,0.91
241,1147054000,서울특별시양천구목4동,25372,10152,2.5,12396,12976,0.96
242,1147055000,서울특별시양천구목5동,41239,13465,3.06,20455,20784,0.98
243,1147056000,서울특별시양천구신월1동,20422,10232,2.0,10490,9932,1.06
244,1147057000,서울특별시양천구신월2동,20665,8465,2.44,10096,10569,0.96
245,1147058000,서울특별시양천구신월3동,15191,7909,1.92,8009,7182,1.12
246,1147059000,서울특별시양천구신월4동,17926,6890,2.6,8759,9167,0.96
247,1147060000,서울특별시양천구신월5동,14615,6470,2.26,7262,7353,0.99
248,1147061000,서울특별시양천구신월6동,13893,5356,2.59,6792,7101,0.96
249,1147061100,서울특별시양천구신월7동,19783,9219,2.15,9677,10106,0.96
250,1147062000,서울특별시양천구신정1동,20374,7103,2.87,9925,10449,0.95
251,1147063000,서울특별시양천구신정2동,19491,7010,2.78,9567,9924,0.96
252,1147064000,서울특별시양천구신정3동,49627,19369,2.56,24148,25479,0.95
253,1147065000,서울특별시양천구신정4동,32698,16180,2.02,15936,16762,0.95
254,1147067000,서울특별시양천구신정6동,24528,8265,2.97,11939,12589,0.95
255,1147068000,서울특별시양천구신정7동,29010,11493,2.52,14020,14990,0.94
256,1150000000,서울특별시강서구,574315,271175,2.12,276292,298023,0.93
257,1150051000,서울특별시강서구염창동,41637,16309,2.55,20144,21493,0.94
258,1150052000,서울특별시강서구등촌제1동,24239,13600,1.78,11243,12996,0.87
259,1150053000,서울특별시강서구등촌제2동,20303,8668,2.34,9914,10389,0.95
260,1150053500,서울특별시강서구등촌제3동,30544,15012,2.03,14486,16058,0.9
261,1150054000,서울특별시강서구화곡제1동,51801,27678,1.87,25174,26627,0.95
262,1150055000,서울특별시강서구화곡제2동,17840,8187,2.18,8662,9178,0.94
263,1150056000,서울특별시강서구화곡제3동,21525,9657,2.23,10297,11228,0.92
264,1150057000,서울특별시강서구화곡제4동,20532,9748,2.11,10038,10494,0.96
265,1150059000,서울특별시강서구화곡본동,34202,17267,1.98,16579,17623,0.94
266,1150059100,서울특별시강서구화곡제6동,24869,12586,1.98,12024,12845,0.94
267,1150059300,서울특별시강서구화곡제8동,24383,11814,2.06,11751,12632,0.93
268,1150060300,서울특별시강서구가양제1동,34115,20536,1.66,15594,18521,0.84
269,1150060400,서울특별시강서구가양제2동,14026,8055,1.74,6618,7408,0.89
270,1150060500,서울특별시강서구가양제3동,15040,7903,1.9,6975,8065,0.86
271,1150061100,서울특별시강서구발산제1동,36416,13446,2.71,17215,19201,0.9
272,1150061500,서울특별시강서구우장산동,42923,16100,2.67,20534,22389,0.92
273,1150062000,서울특별시강서구공항동,30842,14081,2.19,15537,15305,1.02
274,1150063000,서울특별시강서구방화제1동,42932,17256,2.49,20924,22008,0.95
275,1150064000,서울특별시강서구방화제2동,23355,11994,1.95,11527,11828,0.97
276,1150064100,서울특별시강서구방화제3동,22791,11278,2.02,11056,11735,0.94
277,1153000000,서울특별시구로구,396754,180929,2.19,195537,201217,0.97
278,1153051000,서울특별시구로구신도림동,36049,13730,2.63,17517,18532,0.95
279,1153052000,서울특별시구로구구로제1동,20827,8343,2.5,10196,10631,0.96
280,1153053000,서울특별시구로구구로제2동,23802,12608,1.89,12016,11786,1.02
281,1153054000,서울특별시구로구구로제3동,23529,13338,1.76,12087,11442,1.06
282,1153055000,서울특별시구로구구로제4동,19667,10630,1.85,9534,10133,0.94
283,1153056000,서울특별시구로구구로제5동,29212,15130,1.93,14185,15027,0.94
284,1153059500,서울특별시구로구가리봉동,8958,5999,1.49,4900,4058,1.21
285,1153072000,서울특별시구로구고척제1동,22337,9462,2.36,11119,11218,0.99
286,1153073000,서울특별시구로구고척제2동,26631,11508,2.31,13205,13426,0.98
287,1153074000,서울특별시구로구개봉제1동,33775,14926,2.26,16854,16921,1.0
288,1153075000,서울특별시구로구개봉제2동,30894,12575,2.46,15051,15843,0.95
289,1153076000,서울특별시구로구개봉제3동,20222,8824,2.29,9831,10391,0.95
290,1153077000,서울특별시구로구오류제1동,22540,12092,1.86,10945,11595,0.94
291,1153078000,서울특별시구로구오류제2동,38456,15586,2.47,18495,19961,0.93
292,1153079000,서울특별시구로구수궁동,23506,10034,2.34,11591,11915,0.97
293,1153080000,서울특별시구로구항동,16349,6144,2.66,8011,8338,0.96
294,1154500000,서울특별시금천구,230811,117595,1.96,116527,114284,1.02
295,1154551000,서울특별시금천구가산동,23669,16824,1.41,12863,10806,1.19
296,1154561000,서울특별시금천구독산제1동,44873,23295,1.93,22990,21883,1.05
297,1154562000,서울특별시금천구독산제2동,18706,9519,1.97,9465,9241,1.02
298,1154563000,서울특별시금천구독산제3동,24152,12718,1.9,12106,12046,1.0
299,1154564000,서울특별시금천구독산제4동,15142,7668,1.97,7591,7551,1.01
300,1154567000,서울특별시금천구시흥제1동,32826,16104,2.04,16326,16500,0.99
301,1154568000,서울특별시금천구시흥제2동,21228,8255,2.57,10210,11018,0.93
302,1154569000,서울특별시금천구시흥제3동,10800,4736,2.28,5368,5432,0.99
303,1154570000,서울특별시금천구시흥제4동,20249,9129,2.22,10030,10219,0.98
304,1154571000,서울특별시금천구시흥제5동,19166,9347,2.05,9578,9588,1.0
305,1156000000,서울특별시영등포구,376837,187020,2.01,185926,190911,0.97
306,1156051500,서울특별시영등포구영등포본동,21254,10460,2.03,10896,10358,1.05
307,1156053500,서울특별시영등포구영등포동,29233,20390,1.43,15347,13886,1.11
308,1156054000,서울특별시영등포구여의동,33071,13460,2.46,15519,17552,0.88
309,1156055000,서울특별시영등포구당산제1동,20300,10792,1.88,9948,10352,0.96
310,1156056000,서울특별시영등포구당산제2동,37520,18858,1.99,17598,19922,0.88
311,1156058500,서울특별시영등포구도림동,17730,9372,1.89,8946,8784,1.02
312,1156060500,서울특별시영등포구문래동,32627,13131,2.48,15964,16663,0.96
313,1156061000,서울특별시영등포구양평제1동,18197,9666,1.88,8884,9313,0.95
314,1156062000,서울특별시영등포구양평제2동,22301,10662,2.09,10957,11344,0.97
315,1156063000,서울특별시영등포구신길제1동,17342,10599,1.64,8831,8511,1.04
316,1156065000,서울특별시영등포구신길제3동,16561,7650,2.16,8184,8377,0.98
317,1156066000,서울특별시영등포구신길제4동,12324,5746,2.14,6126,6198,0.99
318,1156067000,서울특별시영등포구신길제5동,10611,4803,2.21,5162,5449,0.95
319,1156068000,서울특별시영등포구신길제6동,19076,9118,2.09,9312,9764,0.95
320,1156069000,서울특별시영등포구신길제7동,19968,7900,2.53,9961,10007,1.0
321,1156070000,서울특별시영등포구대림제1동,14525,7123,2.04,7233,7292,0.99
322,1156071000,서울특별시영등포구대림제2동,11912,6879,1.73,5879,6033,0.97
323,1156072000,서울특별시영등포구대림제3동,22285,10411,2.14,11179,11106,1.01
324,1159000000,서울특별시동작구,385483,184812,2.09,186426,199057,0.94
325,1159051000,서울특별시동작구노량진제1동,31962,16187,1.97,16056,15906,1.01
326,1159052000,서울특별시동작구노량진제2동,10844,6969,1.56,5594,5250,1.07
327,1159053000,서울특별시동작구상도제1동,44087,21389,2.06,21372,22715,0.94
328,1159054000,서울특별시동작구상도제2동,28107,12590,2.23,13544,14563,0.93
329,1159055000,서울특별시동작구상도제3동,24512,12009,2.04,11685,12827,0.91
330,1159056000,서울특별시동작구상도제4동,28577,14095,2.03,13864,14713,0.94
331,1159060500,서울특별시동작구흑석동,31485,14065,2.24,15349,16136,0.95
332,1159062000,서울특별시동작구사당제1동,22856,13492,1.69,10890,11966,0.91
333,1159063000,서울특별시동작구사당제2동,27780,12200,2.28,13304,14476,0.92
334,1159064000,서울특별시동작구사당제3동,24344,10472,2.32,11802,12542,0.94
335,1159065000,서울특별시동작구사당제4동,14141,7155,1.98,6766,7375,0.92
336,1159065100,서울특별시동작구사당제5동,14467,6621,2.19,6959,7508,0.93
337,1159066000,서울특별시동작구대방동,37990,17267,2.2,18017,19973,0.9
338,1159067000,서울특별시동작구신대방제1동,23142,10225,2.26,11093,12049,0.92
339,1159068000,서울특별시동작구신대방제2동,21189,10076,2.1,10131,11058,0.92
340,1162000000,서울특별시관악구,485699,276597,1.76,243991,241708,1.01
341,1162052500,서울특별시관악구보라매동,24412,12941,1.89,12014,12398,0.97
342,1162054500,서울특별시관악구청림동,15118,6450,2.34,7358,7760,0.95
343,1162056500,서울특별시관악구성현동,29209,12332,2.37,14091,15118,0.93
344,1162057500,서울특별시관악구행운동,28931,17656,1.64,14040,14891,0.94
345,1162058500,서울특별시관악구낙성대동,16847,11239,1.5,8462,8385,1.01
346,1162059500,서울특별시관악구청룡동,35422,23354,1.52,17083,18339,0.93
347,1162060500,서울특별시관악구은천동,33156,16056,2.07,16152,17004,0.95
348,1162061500,서울특별시관악구중앙동,15106,9801,1.54,7266,7840,0.93
349,1162062500,서울특별시관악구인헌동,25799,14410,1.79,12553,13246,0.95
350,1162063000,서울특별시관악구남현동,18085,9683,1.87,8720,9365,0.93
351,1162064500,서울특별시관악구서원동,22593,14333,1.58,11696,10897,1.07
352,1162065500,서울특별시관악구신원동,17840,10967,1.63,9032,8808,1.03
353,1162066500,서울특별시관악구서림동,23062,14355,1.61,12713,10349,1.23
354,1162068500,서울특별시관악구신사동,22560,13955,1.62,11345,11215,1.01
355,1162069500,서울특별시관악구신림동,22365,17985,1.24,11802,10563,1.12
356,1162071500,서울특별시관악구난향동,15298,6289,2.43,7475,7823,0.96
357,1162072500,서울특별시관악구조원동,17338,10774,1.61,8728,8610,1.01
358,1162073500,서울특별시관악구대학동,23385,16164,1.45,14101,9284,1.52
359,1162074500,서울특별시관악구삼성동,21902,10453,2.1,10976,10926,1.0
360,1162076500,서울특별시관악구미성동,30512,14284,2.14,14950,15562,0.96
361,1162077500,서울특별시관악구난곡동,26759,13116,2.04,13434,13325,1.01
362,1165000000,서울특별시서초구,412279,170244,2.42,197034,215245,0.92
363,1165051000,서울특별시서초구서초1동,20524,9378,2.19,9891,10633,0.93
364,1165052000,서울특별시서초구서초2동,26237,11390,2.3,12536,13701,0.91
365,1165053000,서울특별시서초구서초3동,32437,15260,2.13,15593,16844,0.93
366,1165053100,서울특별시서초구서초4동,30833,10896,2.83,15010,15823,0.95
367,1165054000,서울특별시서초구잠원동,26771,10739,2.49,12878,13893,0.93
368,1165055000,서울특별시서초구반포본동,1969,826,2.38,936,1033,0.91
369,1165056000,서울특별시서초구반포1동,34464,15029,2.29,16766,17698,0.95
370,1165057000,서울특별시서초구반포2동,15707,4981,3.15,7498,8209,0.91
371,1165058000,서울특별시서초구반포3동,22190,7710,2.88,10541,11649,0.9
372,1165058100,서울특별시서초구반포4동,19177,7209,2.66,8985,10192,0.88
373,1165059000,서울특별시서초구방배본동,20907,8001,2.61,9665,11242,0.86
374,1165060000,서울특별시서초구방배1동,16848,7541,2.23,7878,8970,0.88
375,1165061000,서울특별시서초구방배2동,19347,8365,2.31,9073,10274,0.88
376,1165062000,서울특별시서초구방배3동,18783,7118,2.64,9079,9704,0.94
377,1165062100,서울특별시서초구방배4동,23524,9741,2.41,10703,12821,0.83
378,1165065100,서울특별시서초구양재1동,43074,17916,2.4,20554,22520,0.91
379,1165065200,서울특별시서초구양재2동,21927,10894,2.01,10949,10978,1.0
380,1165066000,서울특별시서초구내곡동,17560,7250,2.42,8499,9061,0.94
381,1168000000,서울특별시강남구,533042,234233,2.28,255047,277995,0.92
382,1168051000,서울특별시강남구신사동,15993,7035,2.27,7415,8578,0.86
383,1168052100,서울특별시강남구논현1동,22073,14033,1.57,10381,11692,0.89
384,1168053100,서울특별시강남구논현2동,21018,11414,1.84,9821,11197,0.88
385,1168054500,서울특별시강남구압구정동,26305,10265,2.56,12187,14118,0.86
386,1168056500,서울특별시강남구청담동,25684,11272,2.28,11987,13697,0.88
387,1168058000,서울특별시강남구삼성1동,12878,5483,2.35,6334,6544,0.97
388,1168059000,서울특별시강남구삼성2동,30436,13555,2.25,14560,15876,0.92
389,1168060000,서울특별시강남구대치1동,24165,7264,3.33,12151,12014,1.01
390,1168061000,서울특별시강남구대치2동,36507,12851,2.84,18483,18024,1.03
391,1168063000,서울특별시강남구대치4동,19815,10164,1.95,9364,10451,0.9
392,1168064000,서울특별시강남구역삼1동,35587,24243,1.47,17285,18302,0.94
393,1168065000,서울특별시강남구역삼2동,36072,15507,2.33,16914,19158,0.88
394,1168065500,서울특별시강남구도곡1동,21405,8524,2.51,10133,11272,0.9
395,1168065600,서울특별시강남구도곡2동,33163,11664,2.84,15400,17763,0.87
396,1168066000,서울특별시강남구개포1동,6470,2572,2.52,3147,3323,0.95
397,1168067000,서울특별시강남구개포2동,27874,9683,2.88,13524,14350,0.94
398,1168069000,서울특별시강남구개포4동,23710,10024,2.37,11480,12230,0.94
399,1168070000,서울특별시강남구세곡동,43232,17961,2.41,20426,22806,0.9
400,1168072000,서울특별시강남구일원본동,23260,8058,2.89,11482,11778,0.97
401,1168073000,서울특별시강남구일원1동,15073,7390,2.04,7386,7687,0.96
402,1168074000,서울특별시강남구일원2동,17518,7471,2.34,8479,9039,0.94
403,1168075000,서울특별시강남구수서동,14804,7800,1.9,6708,8096,0.83
404,1171000000,서울특별시송파구,658338,282417,2.33,317346,340992,0.93
405,1171051000,서울특별시송파구풍납1동,12869,5985,2.15,6300,6569,0.96
406,1171052000,서울특별시송파구풍납2동,24785,10976,2.26,11777,13008,0.91
407,1171053100,서울특별시송파구거여1동,12539,5647,2.22,6335,6204,1.02
408,1171053200,서울특별시송파구거여2동,18726,8150,2.3,9210,9516,0.97
409,1171054000,서울특별시송파구마천1동,18916,8814,2.15,9664,9252,1.04
410,1171055000,서울특별시송파구마천2동,18713,8741,2.14,9536,9177,1.04
411,1171056100,서울특별시송파구방이1동,15682,6229,2.52,7555,8127,0.93
412,1171056200,서울특별시송파구방이2동,26489,15258,1.74,12304,14185,0.87
413,1171056600,서울특별시송파구오륜동,18061,5929,3.05,8824,9237,0.96
414,1171057000,서울특별시송파구오금동,38446,15640,2.46,18636,19810,0.94
415,1171058000,서울특별시송파구송파1동,23845,12261,1.94,11129,12716,0.88
416,1171059000,서울특별시송파구송파2동,19130,7209,2.65,9221,9909,0.93
417,1171060000,서울특별시송파구석촌동,31584,16917,1.87,15066,16518,0.91
418,1171061000,서울특별시송파구삼전동,30325,16080,1.89,14254,16071,0.89
419,1171062000,서울특별시송파구가락본동,26252,11833,2.22,13019,13233,0.98
420,1171063100,서울특별시송파구가락1동,27265,9786,2.79,13203,14062,0.94
421,1171063200,서울특별시송파구가락2동,32229,12429,2.59,15820,16409,0.96
422,1171064100,서울특별시송파구문정1동,20012,8494,2.36,9922,10090,0.98
423,1171064200,서울특별시송파구문정2동,28871,15731,1.84,13266,15605,0.85
424,1171064600,서울특별시송파구장지동,29534,12141,2.43,14278,15256,0.94
425,1171064700,서울특별시송파구위례동,39095,12651,3.09,19042,20053,0.95
426,1171065000,서울특별시송파구잠실본동,27953,15442,1.81,13264,14689,0.9
427,1171067000,서울특별시송파구잠실2동,35036,11613,3.02,16756,18280,0.92
428,1171068000,서울특별시송파구잠실3동,34338,11912,2.88,16337,18001,0.91
429,1171069000,서울특별시송파구잠실4동,21318,7277,2.93,10229,11089,0.92
430,1171071000,서울특별시송파구잠실6동,16775,5889,2.85,7945,8830,0.9
431,1171072000,서울특별시송파구잠실7동,9550,3383,2.82,4454,5096,0.87
432,1174000000,서울특별시강동구,462664,201613,2.29,227002,235662,0.96
433,1174051500,서울특별시강동구강일동,32794,12857,2.55,15740,17054,0.92
434,1174052500,서울특별시강동구상일제1동,38834,13496,2.88,19154,19680,0.97
435,1174052600,서울특별시강동구상일제2동,10166,3944,2.58,4773,5393,0.89
436,1174053000,서울특별시강동구명일제1동,25856,10117,2.56,12589,13267,0.95
437,1174054000,서울특별시강동구명일제2동,17524,6511,2.69,8590,8934,0.96
438,1174055000,서울특별시강동구고덕제1동,24301,8343,2.91,12344,11957,1.03
439,1174056000,서울특별시강동구고덕제2동,22177,8781,2.53,11169,11008,1.01
440,1174057000,서울특별시강동구암사제1동,34486,15964,2.16,17114,17372,0.99
441,1174058000,서울특별시강동구암사제2동,15197,6353,2.39,7367,7830,0.94
442,1174059000,서울특별시강동구암사제3동,17898,6267,2.86,8763,9135,0.96
443,1174060000,서울특별시강동구천호제1동,26738,12917,2.07,13123,13615,0.96
444,1174061000,서울특별시강동구천호제2동,33154,17473,1.9,16280,16874,0.96
445,1174062000,서울특별시강동구천호제3동,26564,14368,1.85,12924,13640,0.95
446,1174064000,서울특별시강동구성내제1동,19915,8352,2.38,9611,10304,0.93
447,1174065000,서울특별시강동구성내제2동,23534,12810,1.84,11614,11920,0.97
448,1174066000,서울특별시강동구성내제3동,23079,10670,2.16,11326,11753,0.96
449,1174068500,서울특별시강동구길동,45653,21820,2.09,22299,23354,0.95
450,1174069000,서울특별시강동구둔촌제1동,133,82,1.62,75,58,1.29
451,1174070000,서울특별시강동구둔촌제2동,24661,10488,2.35,12147,12514,0.97
452,2600000000,부산광역시,3350380,1544663,2.17,1639044,1711336,0.96
453,2611000000,부산광역시중구,40524,23925,1.69,19755,20769,0.95
454,2611051000,부산광역시중구중앙동,2937,2226,1.32,1405,1532,0.92
455,2611052000,부산광역시중구동광동,2675,1729,1.55,1361,1314,1.04
456,2611053000,부산광역시중구대청동,6252,3502,1.79,2926,3326,0.88
457,2611054500,부산광역시중구보수동,10521,5953,1.77,5084,5437,0.94
458,2611056000,부산광역시중구부평동,4511,2745,1.64,2144,2367,0.91
459,2611057000,부산광역시중구광복동,974,593,1.64,496,478,1.04
460,2611058000,부산광역시중구남포동,915,634,1.44,529,386,1.37
461,2611059000,부산광역시중구영주제1동,4693,2941,1.6,2403,2290,1.05
462,2611060000,부산광역시중구영주제2동,7046,3602,1.96,3407,3639,0.94
463,2614000000,부산광역시서구,105164,52960,1.99,50853,54311,0.94
464,2614051000,부산광역시서구동대신제1동,5614,2752,2.04,2744,2870,0.96
465,2614052000,부산광역시서구동대신제2동,7333,3617,2.03,3563,3770,0.95
466,2614053000,부산광역시서구동대신제3동,7702,3906,1.97,3614,4088,0.88
467,2614054000,부산광역시서구서대신제1동,13712,6193,2.21,6456,7256,0.89
468,2614056000,부산광역시서구서대신제3동,8120,3329,2.44,3724,4396,0.85
469,2614057000,부산광역시서구서대신제4동,7758,3165,2.45,3737,4021,0.93
470,2614059000,부산광역시서구부민동,7517,4066,1.85,3548,3969,0.89
471,2614061500,부산광역시서구아미동,6607,3872,1.71,3350,3257,1.03
472,2614063000,부산광역시서구초장동,4271,2563,1.67,2164,2107,1.03
473,2614064000,부산광역시서구충무동,9896,5570,1.78,4717,5179,0.91
474,2614065000,부산광역시서구남부민제1동,4870,2745,1.77,2464,2406,1.02
475,2614066000,부산광역시서구남부민제2동,8992,4840,1.86,4480,4512,0.99
476,2614068000,부산광역시서구암남동,12772,6342,2.01,6292,6480,0.97
477,2617000000,부산광역시동구,87679,46362,1.89,42877,44802,0.96
478,2617051000,부산광역시동구초량제1동,5027,2996,1.68,2532,2495,1.01
479,2617052000,부산광역시동구초량제2동,5701,3371,1.69,2826,2875,0.98
480,2617053000,부산광역시동구초량제3동,13029,6489,2.01,6331,6698,0.95
481,2617055000,부산광역시동구초량제6동,5953,3175,1.87,2908,3045,0.96
482,2617056000,부산광역시동구수정제1동,4160,2037,2.04,2022,2138,0.95
483,2617057000,부산광역시동구수정제2동,9819,5151,1.91,4654,5165,0.9
484,2617059000,부산광역시동구수정제4동,3902,2239,1.74,1921,1981,0.97
485,2617060000,부산광역시동구수정제5동,5306,2725,1.95,2535,2771,0.91
486,2617064500,부산광역시동구좌천동,10783,5398,2.0,5231,5552,0.94
487,2617065000,부산광역시동구범일제1동,11789,6278,1.88,5821,5968,0.98
488,2617066000,부산광역시동구범일제2동,7862,4361,1.8,3951,3911,1.01
489,2617068000,부산광역시동구범일제5동,4348,2142,2.03,2145,2203,0.97
490,2620000000,부산광역시영도구,110638,54659,2.02,54471,56167,0.97
491,2620053000,부산광역시영도구남항동,10846,5706,1.9,5417,5429,1.0
492,2620054000,부산광역시영도구영선제1동,3995,1916,2.09,1919,2076,0.92
493,2620055000,부산광역시영도구영선제2동,8287,3848,2.15,4014,4273,0.94
494,2620058500,부산광역시영도구신선동,8321,4605,1.81,4183,4138,1.01
495,2620059000,부산광역시영도구봉래제1동,6741,3337,2.02,3329,3412,0.98
496,2620060500,부산광역시영도구봉래제2동,7911,3711,2.13,3849,4062,0.95
497,2620063000,부산광역시영도구청학제1동,6113,3014,2.03,2993,3120,0.96
498,2620064000,부산광역시영도구청학제2동,17625,7886,2.23,8719,8906,0.98
499,2620065000,부산광역시영도구동삼제1동,27532,12938,2.13,13450,14082,0.96
500,2620066000,부산광역시영도구동삼제2동,3354,1840,1.82,1778,1576,1.13
501,2620067000,부산광역시영도구동삼제3동,9913,5858,1.69,4820,5093,0.95
502,2623000000,부산광역시부산진구,353159,173353,2.04,170181,182978,0.93
503,2623051000,부산광역시부산진구부전제1동,15902,10310,1.54,7948,7954,1.0
504,2623052000,부산광역시부산진구부전제2동,9930,5626,1.77,4953,4977,1.0
505,2623054000,부산광역시부산진구연지동,20607,8703,2.37,9736,10871,0.9
506,2623055000,부산광역시부산진구초읍동,22133,10081,2.2,10680,11453,0.93
507,2623056000,부산광역시부산진구양정제1동,20028,9215,2.17,9427,10601,0.89
508,2623057000,부산광역시부산진구양정제2동,11985,7560,1.59,5483,6502,0.84
509,2623060000,부산광역시부산진구전포제1동,21776,12050,1.81,10418,11358,0.92
510,2623061000,부산광역시부산진구전포제2동,20853,11475,1.82,9761,11092,0.88
511,2623064000,부산광역시부산진구부암제1동,22999,9858,2.33,11228,11771,0.95
512,2623066000,부산광역시부산진구부암제3동,17437,6958,2.51,8571,8866,0.97
513,2623067000,부산광역시부산진구당감제1동,23065,10377,2.22,11013,12052,0.91
514,2623068000,부산광역시부산진구당감제2동,10274,4661,2.2,4898,5376,0.91
515,2623070000,부산광역시부산진구당감제4동,11323,5139,2.2,5535,5788,0.96
516,2623071000,부산광역시부산진구가야제1동,19224,10159,1.89,9624,9600,1.0
517,2623072000,부산광역시부산진구가야제2동,16844,7322,2.3,8179,8665,0.94
518,2623074000,부산광역시부산진구개금제1동,16724,8866,1.89,8024,8700,0.92
519,2623075000,부산광역시부산진구개금제2동,10948,4995,2.19,5343,5605,0.95
520,2623076000,부산광역시부산진구개금제3동,28813,12490,2.31,13899,14914,0.93
521,2623077000,부산광역시부산진구범천제1동,11965,7167,1.67,5630,6335,0.89
522,2623078000,부산광역시부산진구범천제2동,20329,10341,1.97,9831,10498,0.94
523,2626000000,부산광역시동래구,266866,115718,2.31,129681,137185,0.95
524,2626051000,부산광역시동래구수민동,32558,13661,2.38,15792,16766,0.94
525,2626052000,부산광역시동래구복산동,9523,4753,2.0,4638,4885,0.95
526,2626054500,부산광역시동래구명륜동,24724,9426,2.62,12141,12583,0.96
527,2626055000,부산광역시동래구온천제1동,20551,11394,1.8,9724,10827,0.9
528,2626056000,부산광역시동래구온천제2동,14933,6351,2.35,7155,7778,0.92
529,2626057000,부산광역시동래구온천제3동,38542,17461,2.21,18849,19693,0.96
530,2626058000,부산광역시동래구사직제1동,10614,4807,2.21,5095,5519,0.92
531,2626059000,부산광역시동래구사직제2동,27315,9519,2.87,13166,14149,0.93
532,2626060000,부산광역시동래구사직제3동,17447,7516,2.32,8662,8785,0.99
533,2626074000,부산광역시동래구안락제1동,14560,6906,2.11,7167,7393,0.97
534,2626075000,부산광역시동래구안락제2동,27185,11111,2.45,13233,13952,0.95
535,2626076100,부산광역시동래구명장제1동,14048,6209,2.26,6804,7244,0.94
536,2626076200,부산광역시동래구명장제2동,14866,6604,2.25,7255,7611,0.95
537,2629000000,부산광역시남구,262069,117821,2.22,127955,134114,0.95
538,2629051000,부산광역시남구대연제1동,15794,8998,1.76,7975,7819,1.02
539,2629053000,부산광역시남구대연제3동,32729,15596,2.1,16000,16729,0.96
540,2629054000,부산광역시남구대연제4동,12382,5496,2.25,6067,6315,0.96
541,2629055000,부산광역시남구대연제5동,17004,8170,2.08,8156,8848,0.92
542,2629056000,부산광역시남구대연제6동,15382,5926,2.6,7396,7986,0.93
543,2629057000,부산광역시남구용호제1동,44281,17171,2.58,21254,23027,0.92
544,2629058000,부산광역시남구용호제2동,16850,6684,2.52,8240,8610,0.96
545,2629059000,부산광역시남구용호제3동,12228,5695,2.15,5915,6313,0.94
546,2629060000,부산광역시남구용호제4동,8542,3849,2.22,4107,4435,0.93
547,2629061000,부산광역시남구용당동,8249,3489,2.36,4152,4097,1.01
548,2629062000,부산광역시남구감만제1동,12970,6148,2.11,6623,6347,1.04
549,2629063000,부산광역시남구감만제2동,6768,3301,2.05,3318,3450,0.96
550,2629064500,부산광역시남구우암동,12818,5765,2.22,6321,6497,0.97
551,2629068000,부산광역시남구문현제1동,13577,5884,2.31,6610,6967,0.95
552,2629069000,부산광역시남구문현제2동,8564,5046,1.7,4213,4351,0.97
553,2629070000,부산광역시남구문현제3동,15632,6606,2.37,7566,8066,0.94
554,2629071000,부산광역시남구문현제4동,8299,3997,2.08,4042,4257,0.95
555,2632000000,부산광역시북구,283211,123316,2.3,139795,143416,0.97
556,2632051000,부산광역시북구구포제1동,16096,8141,1.98,8116,7980,1.02
557,2632052000,부산광역시북구구포제2동,25270,11793,2.14,12934,12336,1.05
558,2632052100,부산광역시북구구포제3동,19686,9262,2.13,10142,9544,1.06
559,2632053000,부산광역시북구금곡동,37959,18148,2.09,18342,19617,0.94
560,2632054100,부산광역시북구화명제1동,41610,14477,2.87,20378,21232,0.96
561,2632054200,부산광역시북구화명제2동,17112,7029,2.43,8349,8763,0.95
562,2632054300,부산광역시북구화명제3동,29748,10795,2.76,14538,15210,0.96
563,2632055000,부산광역시북구덕천제1동,11116,6077,1.83,5488,5628,0.98
564,2632056000,부산광역시북구덕천제2동,12011,6660,1.8,5974,6037,0.99
565,2632056100,부산광역시북구덕천제3동,10765,5660,1.9,5266,5499,0.96
566,2632057100,부산광역시북구만덕제1동,16664,7165,2.33,8182,8482,0.96
567,2632057200,부산광역시북구만덕제2동,26504,10660,2.49,13007,13497,0.96
568,2632057300,부산광역시북구만덕제3동,18670,7449,2.51,9079,9591,0.95
569,2635000000,부산광역시해운대구,396438,172397,2.3,190624,205814,0.93
570,2635051000,부산광역시해운대구우제1동,22426,10903,2.06,10657,11769,0.91
571,2635052000,부산광역시해운대구우제2동,30613,11855,2.58,14578,16035,0.91
572,2635052500,부산광역시해운대구우제3동,28855,10989,2.63,13655,15200,0.9
573,2635053000,부산광역시해운대구중제1동,27743,12241,2.27,13323,14420,0.92
574,2635054000,부산광역시해운대구중제2동,15944,7536,2.12,7607,8337,0.91
575,2635055100,부산광역시해운대구좌제1동,18104,7811,2.32,8425,9679,0.87
576,2635055200,부산광역시해운대구좌제2동,32065,14180,2.26,14775,17290,0.85
577,2635055300,부산광역시해운대구좌제3동,16150,6445,2.51,7585,8565,0.89
578,2635055400,부산광역시해운대구좌제4동,23142,8641,2.68,10982,12160,0.9
579,2635056000,부산광역시해운대구송정동,9916,5100,1.94,4784,5132,0.93
580,2635057000,부산광역시해운대구반여제1동,34538,13113,2.63,17047,17491,0.97
581,2635058000,부산광역시해운대구반여제2동,12677,6862,1.85,6167,6510,0.95
582,2635059000,부산광역시해운대구반여제3동,8559,4614,1.86,4200,4359,0.96
583,2635059500,부산광역시해운대구반여제4동,16083,6079,2.65,7937,8146,0.97
584,2635061000,부산광역시해운대구반송제1동,13816,7905,1.75,6920,6896,1.0
585,2635062000,부산광역시해운대구반송제2동,23270,11966,1.94,11315,11955,0.95
586,2635065000,부산광역시해운대구재송제1동,37812,14664,2.58,18588,19224,0.97
587,2635066000,부산광역시해운대구재송제2동,24725,11493,2.15,12079,12646,0.96
588,2638000000,부산광역시사하구,306003,139604,2.19,152197,153806,0.99
589,2638051000,부산광역시사하구괴정제1동,19535,8722,2.24,9381,10154,0.92
590,2638052000,부산광역시사하구괴정제2동,14022,6306,2.22,6868,7154,0.96
591,2638053000,부산광역시사하구괴정제3동,12474,6449,1.93,5965,6509,0.92
592,2638054000,부산광역시사하구괴정제4동,12258,5553,2.21,5950,6308,0.94
593,2638055000,부산광역시사하구당리동,26557,11445,2.32,12977,13580,0.96
594,2638056100,부산광역시사하구하단제1동,21531,10401,2.07,10739,10792,1.0
595,2638056200,부산광역시사하구하단제2동,25356,12871,1.97,12632,12724,0.99
596,2638057100,부산광역시사하구신평제1동,16925,8258,2.05,8750,8175,1.07
597,2638057200,부산광역시사하구신평제2동,15747,6733,2.34,7879,7868,1.0
598,2638058000,부산광역시사하구장림제1동,10720,4963,2.16,5551,5169,1.07
599,2638059000,부산광역시사하구장림제2동,27335,11876,2.3,13882,13453,1.03
600,2638060100,부산광역시사하구다대제1동,38840,17011,2.28,19440,19400,1.0
601,2638060200,부산광역시사하구다대제2동,27296,12153,2.25,13411,13885,0.97
602,2638061000,부산광역시사하구구평동,12900,5228,2.47,6586,6314,1.04
603,2638062000,부산광역시사하구감천제1동,18576,8294,2.24,9142,9434,0.97
604,2638063000,부산광역시사하구감천제2동,5931,3341,1.78,3044,2887,1.05
605,2641000000,부산광역시금정구,228049,108070,2.11,111513,116536,0.96
606,2641051000,부산광역시금정구서제1동,5315,3174,1.67,2747,2568,1.07
607,2641052000,부산광역시금정구서제2동,9218,4958,1.86,4600,4618,1.0
608,2641053000,부산광역시금정구서제3동,11231,5957,1.89,5607,5624,1.0
609,2641055500,부산광역시금정구금사회동동,7885,4168,1.89,4154,3731,1.11
610,2641057000,부산광역시금정구부곡제1동,8244,4479,1.84,3968,4276,0.93
611,2641058000,부산광역시금정구부곡제2동,17983,7954,2.26,8579,9404,0.91
612,2641059000,부산광역시금정구부곡제3동,15789,6875,2.3,7605,8184,0.93
613,2641059100,부산광역시금정구부곡제4동,12839,6124,2.1,6182,6657,0.93
614,2641060000,부산광역시금정구장전제1동,18053,10811,1.67,9415,8638,1.09
615,2641061000,부산광역시금정구장전제2동,26706,11715,2.28,12886,13820,0.93
616,2641063500,부산광역시금정구선두구동,2331,1275,1.83,1249,1082,1.15
617,2641066500,부산광역시금정구청룡노포동,9733,4398,2.21,4762,4971,0.96
618,2641067000,부산광역시금정구남산동,28867,14174,2.04,14072,14795,0.95
619,2641068000,부산광역시금정구구서제1동,19695,8075,2.44,9357,10338,0.91
620,2641069000,부산광역시금정구구서제2동,33114,13457,2.46,15829,17285,0.92
621,2641070000,부산광역시금정구금성동,1046,476,2.2,501,545,0.92
622,2644000000,부산광역시강서구,142918,61502,2.32,74047,68871,1.08
623,2644051000,부산광역시강서구대저1동,6556,3740,1.75,3593,2963,1.21
624,2644052000,부산광역시강서구대저2동,7090,3726,1.9,3986,3104,1.28
625,2644053000,부산광역시강서구강동동,4220,2527,1.67,2264,1956,1.16
626,2644053500,부산광역시강서구명지1동,53087,20640,2.57,26708,26379,1.01
627,2644054500,부산광역시강서구명지2동,30409,10307,2.95,15173,15236,1.0
628,2644055000,부산광역시강서구가락동,2345,1353,1.73,1251,1094,1.14
629,2644056000,부산광역시강서구녹산동,35270,16742,2.11,19002,16268,1.17
630,2644058000,부산광역시강서구가덕도동,3941,2467,1.6,2070,1871,1.11
631,2647000000,부산광역시연제구,207144,93606,2.21,99761,107383,0.93
632,2647061000,부산광역시연제구거제제1동,29232,11391,2.57,14122,15110,0.93
633,2647062000,부산광역시연제구거제제2동,12232,4562,2.68,5817,6415,0.91
634,2647063000,부산광역시연제구거제제3동,9988,4706,2.12,4734,5254,0.9
635,2647064000,부산광역시연제구거제제4동,10429,4166,2.5,5120,5309,0.96
636,2647065000,부산광역시연제구연산제1동,16775,7161,2.34,8186,8589,0.95
637,2647066000,부산광역시연제구연산제2동,20674,9195,2.25,9944,10730,0.93
638,2647067000,부산광역시연제구연산제3동,9160,4552,2.01,4440,4720,0.94
639,2647068000,부산광역시연제구연산제4동,16154,8595,1.88,7798,8356,0.93
640,2647069000,부산광역시연제구연산제5동,16588,10204,1.63,7924,8664,0.91
641,2647070000,부산광역시연제구연산제6동,16699,8166,2.04,8051,8648,0.93
642,2647072000,부산광역시연제구연산제8동,14138,6212,2.28,6875,7263,0.95
643,2647073000,부산광역시연제구연산제9동,35075,14696,2.39,16750,18325,0.91
644,2650000000,부산광역시수영구,175095,85896,2.04,82609,92486,0.89
645,2650066000,부산광역시수영구남천제1동,13853,6326,2.19,6376,7477,0.85
646,2650067000,부산광역시수영구남천제2동,12091,4929,2.45,5665,6426,0.88
647,2650073000,부산광역시수영구수영동,14651,7896,1.86,7012,7639,0.92
648,2650074000,부산광역시수영구망미제1동,27404,12415,2.21,13078,14326,0.91
649,2650075000,부산광역시수영구망미제2동,10703,4950,2.16,5270,5433,0.97
650,2650076000,부산광역시수영구광안제1동,25866,14239,1.82,12031,13835,0.87
651,2650077000,부산광역시수영구광안제2동,18688,9632,1.94,8676,10012,0.87
652,2650078000,부산광역시수영구광안제3동,9597,5986,1.6,4534,5063,0.9
653,2650079000,부산광역시수영구광안제4동,13715,6284,2.18,6207,7508,0.83
654,2650080000,부산광역시수영구민락동,28527,13239,2.15,13760,14767,0.93
655,2653000000,부산광역시사상구,208298,98621,2.11,105034,103264,1.02
656,2653058000,부산광역시사상구삼락동,5808,3144,1.85,3099,2709,1.14
657,2653059100,부산광역시사상구모라제1동,27998,12502,2.24,13961,14037,0.99
658,2653059300,부산광역시사상구모라제3동,10412,6718,1.55,4977,5435,0.92
659,2653060000,부산광역시사상구덕포제1동,8683,4278,2.03,4440,4243,1.05
660,2653061000,부산광역시사상구덕포제2동,12921,5766,2.24,6545,6376,1.03
661,2653062000,부산광역시사상구괘법동,22414,12792,1.75,11602,10812,1.07
662,2653064500,부산광역시사상구감전동,13318,7237,1.84,7058,6260,1.13
663,2653065000,부산광역시사상구주례제1동,15160,6436,2.36,7740,7420,1.04
664,2653066000,부산광역시사상구주례제2동,23075,11285,2.04,11542,11533,1.0
665,2653066100,부산광역시사상구주례제3동,13154,5741,2.29,6438,6716,0.96
666,2653067000,부산광역시사상구학장동,28294,12171,2.32,14129,14165,1.0
667,2653068000,부산광역시사상구엄궁동,27061,10551,2.56,13503,13558,1.0
668,2671000000,부산광역시기장군,177125,76853,2.3,87691,89434,0.98
669,2671025000,부산광역시기장군기장읍,52846,25598,2.06,25761,27085,0.95
670,2671025300,부산광역시기장군장안읍,8608,4732,1.82,4632,3976,1.16
671,2671025600,부산광역시기장군정관읍,81932,31904,2.57,40501,41431,0.98
672,2671031000,부산광역시기장군일광면,25817,10728,2.41,12779,13038,0.98
673,2671033000,부산광역시기장군철마면,7922,3891,2.04,4018,3904,1.03
674,2700000000,대구광역시,2385412,1063893,2.24,1175632,1209780,0.97
675,2711000000,대구광역시중구,74791,38370,1.95,35948,38843,0.93
676,2711051700,대구광역시중구동인동,8053,4852,1.66,4039,4014,1.01
677,2711054500,대구광역시중구삼덕동,6587,4091,1.61,3123,3464,0.9
678,2711056500,대구광역시중구성내1동,4851,3314,1.46,2332,2519,0.93
679,2711057500,대구광역시중구성내2동,4368,2818,1.55,2204,2164,1.02
680,2711058500,대구광역시중구성내3동,4791,2334,2.05,2408,2383,1.01
681,2711059500,대구광역시중구대신동,7857,3300,2.38,3827,4030,0.95
682,2711064000,대구광역시중구남산1동,4792,2731,1.75,2295,2497,0.92
683,2711065000,대구광역시중구남산2동,6507,3020,2.15,3100,3407,0.91
684,2711066000,대구광역시중구남산3동,6678,2925,2.28,3083,3595,0.86
685,2711067000,대구광역시중구남산4동,11485,4879,2.35,5358,6127,0.87
686,2711068000,대구광역시중구대봉1동,6919,3105,2.23,3232,3687,0.88
687,2711069000,대구광역시중구대봉2동,1903,1001,1.9,947,956,0.99
688,2714000000,대구광역시동구,341436,158423,2.16,167888,173548,0.97
689,2714051000,대구광역시동구신암1동,8574,4458,1.92,4288,4286,1.0
690,2714052000,대구광역시동구신암2동,10362,4475,2.32,4907,5455,0.9
691,2714053000,대구광역시동구신암3동,11626,5164,2.25,5710,5916,0.97
692,2714054000,대구광역시동구신암4동,11477,6371,1.8,5776,5701,1.01
693,2714054100,대구광역시동구신암5동,6327,3174,1.99,2989,3338,0.9
694,2714055500,대구광역시동구신천1.2동,12925,6141,2.1,6131,6794,0.9
695,2714057000,대구광역시동구신천3동,11702,5077,2.3,5784,5918,0.98
696,2714058000,대구광역시동구신천4동,7736,4809,1.61,3873,3863,1.0
697,2714059000,대구광역시동구효목1동,13742,7091,1.94,6835,6907,0.99
698,2714060000,대구광역시동구효목2동,13254,6461,2.05,6326,6928,0.91
699,2714061500,대구광역시동구도평동,4005,2055,1.95,2133,1872,1.14
700,2714062000,대구광역시동구불로.봉무동,21335,8784,2.43,10479,10856,0.97
701,2714064000,대구광역시동구지저동,14472,6989,2.07,7209,7263,0.99
702,2714065500,대구광역시동구동촌동,15616,7817,2.0,7850,7766,1.01
703,2714067000,대구광역시동구방촌동,18792,8380,2.24,9055,9737,0.93
704,2714068500,대구광역시동구해안동,15104,7255,2.08,7576,7528,1.01
705,2714072000,대구광역시동구안심1동,42284,19974,2.12,20702,21582,0.96
706,2714073000,대구광역시동구안심2동,11009,4996,2.2,5521,5488,1.01
707,2714074200,대구광역시동구안심3동,21493,8414,2.55,10397,11096,0.94
708,2714074700,대구광역시동구안심4동,29116,11937,2.44,14387,14729,0.98
709,2714075500,대구광역시동구혁신동,18752,8661,2.17,9283,9469,0.98
710,2714076000,대구광역시동구공산동,21733,9940,2.19,10677,11056,0.97
711,2717000000,대구광역시서구,164528,82301,2.0,82241,82287,1.0
712,2717051000,대구광역시서구내당1동,8419,4216,2.0,4153,4266,0.97
713,2717052500,대구광역시서구내당2.3동,9788,5064,1.93,4718,5070,0.93
714,2717054000,대구광역시서구내당4동,16631,8106,2.05,8030,8601,0.93
715,2717055000,대구광역시서구비산1동,9721,4951,1.96,4961,4760,1.04
716,2717056500,대구광역시서구비산2.3동,9263,5102,1.82,4590,4673,0.98
717,2717058000,대구광역시서구비산4동,9798,4753,2.06,4790,5008,0.96
718,2717059000,대구광역시서구비산5동,6095,3416,1.78,3110,2985,1.04
719,2717060000,대구광역시서구비산6동,7647,3826,2.0,3765,3882,0.97
720,2717061000,대구광역시서구비산7동,10002,5627,1.78,5311,4691,1.13
721,2717062000,대구광역시서구평리1동,7823,4018,1.95,3928,3895,1.01
722,2717063000,대구광역시서구평리2동,8028,3649,2.2,3919,4109,0.95
723,2717064000,대구광역시서구평리3동,9905,5107,1.94,5000,4905,1.02
724,2717065000,대구광역시서구평리4동,18034,8554,2.11,8954,9080,0.99
725,2717066000,대구광역시서구평리5동,1739,913,1.9,915,824,1.11
726,2717066100,대구광역시서구평리6동,3939,2023,1.95,2126,1813,1.17
727,2717067500,대구광역시서구상중이동,20072,8915,2.25,10107,9965,1.01
728,2717069500,대구광역시서구원대동,7624,4061,1.88,3864,3760,1.03
729,2720000000,대구광역시남구,143175,76256,1.88,68799,74376,0.93
730,2720051500,대구광역시남구이천동,12062,5602,2.15,5684,6378,0.89
731,2720053000,대구광역시남구봉덕1동,9158,5266,1.74,4410,4748,0.93
732,2720054000,대구광역시남구봉덕2동,12582,5526,2.28,5987,6595,0.91
733,2720055000,대구광역시남구봉덕3동,16654,8417,1.98,7940,8714,0.91
734,2720056000,대구광역시남구대명1동,11333,5869,1.93,5538,5795,0.96
735,2720057100,대구광역시남구대명2동,10227,6079,1.68,4847,5380,0.9
736,2720058600,대구광역시남구대명3동,10794,6269,1.72,5333,5461,0.98
737,2720059000,대구광역시남구대명4동,11062,6016,1.84,5377,5685,0.95
738,2720060000,대구광역시남구대명5동,6303,3639,1.73,2982,3321,0.9
739,2720061000,대구광역시남구대명6동,9581,5220,1.84,4597,4984,0.92
740,2720064000,대구광역시남구대명9동,15672,8523,1.84,7675,7997,0.96
741,2720065000,대구광역시남구대명10동,9124,5051,1.81,4317,4807,0.9
742,2720066000,대구광역시남구대명11동,8623,4779,1.8,4112,4511,0.91
743,2723000000,대구광역시북구,437008,190956,2.29,217420,219588,0.99
744,2723051000,대구광역시북구고성동,4882,2266,2.15,2377,2505,0.95
745,2723052600,대구광역시북구칠성동,23463,10442,2.25,11273,12190,0.92
746,2723055000,대구광역시북구침산1동,4103,2058,1.99,2191,1912,1.15
747,2723056000,대구광역시북구침산2동,18811,7006,2.68,9045,9766,0.93
748,2723057000,대구광역시북구침산3동,19909,7550,2.64,9608,10301,0.93
749,2723061000,대구광역시북구산격1동,9205,5262,1.75,4573,4632,0.99
750,2723062000,대구광역시북구산격2동,10848,4740,2.29,5299,5549,0.95
751,2723063000,대구광역시북구산격3동,8998,5823,1.55,4686,4312,1.09
752,2723063100,대구광역시북구산격4동,8408,4488,1.87,4401,4007,1.1
753,2723064500,대구광역시북구대현동,17759,9070,1.96,8951,8808,1.02
754,2723067100,대구광역시북구복현1동,7552,4895,1.54,4147,3405,1.22
755,2723067200,대구광역시북구복현2동,30640,12212,2.51,15196,15444,0.98
756,2723068000,대구광역시북구검단동,6472,3214,2.01,3215,3257,0.99
757,2723069500,대구광역시북구무태조야동,36441,15255,2.39,18564,17877,1.04
758,2723071500,대구광역시북구관문동,36550,14736,2.48,18215,18335,0.99
759,2723072500,대구광역시북구태전1동,22089,10331,2.14,11087,11002,1.01
760,2723073500,대구광역시북구태전2동,24451,10826,2.26,12041,12410,0.97
761,2723074500,대구광역시북구구암동,35072,13487,2.6,17240,17832,0.97
762,2723075000,대구광역시북구관음동,16469,7488,2.2,8321,8148,1.02
763,2723077000,대구광역시북구읍내동,26862,11698,2.3,13311,13551,0.98
764,2723078000,대구광역시북구동천동,27904,10529,2.65,13541,14363,0.94
765,2723079000,대구광역시북구노원동,11583,5851,1.98,6040,5543,1.09
766,2723080000,대구광역시북구국우동,28537,11729,2.43,14098,14439,0.98
767,2726000000,대구광역시수성구,417097,171239,2.44,201689,215408,0.94
768,2726051000,대구광역시수성구범어1동,16731,6427,2.6,7945,8786,0.9
769,2726052000,대구광역시수성구범어2동,15579,7005,2.22,7569,8010,0.94
770,2726053000,대구광역시수성구범어3동,16171,6010,2.69,7760,8411,0.92
771,2726054000,대구광역시수성구범어4동,19961,6682,2.99,9793,10168,0.96
772,2726055000,대구광역시수성구만촌1동,22788,9011,2.53,11097,11691,0.95
773,2726056000,대구광역시수성구만촌2동,10944,5066,2.16,5421,5523,0.98
774,2726056100,대구광역시수성구만촌3동,19735,6900,2.86,10311,9424,1.09
775,2726057000,대구광역시수성구수성1가동,18024,7202,2.5,8287,9737,0.85
776,2726058000,대구광역시수성구수성2.3가동,11899,4706,2.53,5783,6116,0.95
777,2726059000,대구광역시수성구수성4가동,14625,5897,2.48,6813,7812,0.87
778,2726060100,대구광역시수성구황금1동,23873,8338,2.86,11430,12443,0.92
779,2726060200,대구광역시수성구황금2동,10815,5647,1.92,5211,5604,0.93
780,2726061000,대구광역시수성구중동,11020,5738,1.92,5517,5503,1.0
781,2726062000,대구광역시수성구상동,16318,7943,2.05,7903,8415,0.94
782,2726063000,대구광역시수성구파동,12574,5553,2.26,6031,6543,0.92
783,2726064000,대구광역시수성구두산동,14144,7038,2.01,6903,7241,0.95
784,2726065100,대구광역시수성구지산1동,21893,10633,2.06,10424,11469,0.91
785,2726065200,대구광역시수성구지산2동,18714,7984,2.34,8825,9889,0.89
786,2726066100,대구광역시수성구범물1동,11318,5966,1.9,5140,6178,0.83
787,2726066200,대구광역시수성구범물2동,17173,6663,2.58,8318,8855,0.94
788,2726067000,대구광역시수성구고산1동,30751,11203,2.74,14869,15882,0.94
789,2726068000,대구광역시수성구고산2동,28776,11053,2.6,14297,14479,0.99
790,2726069000,대구광역시수성구고산3동,33271,12574,2.65,16042,17229,0.93
791,2729000000,대구광역시달서구,544926,234950,2.32,268498,276428,0.97
792,2729051500,대구광역시달서구성당동,23255,10708,2.17,11272,11983,0.94
793,2729053500,대구광역시달서구두류1.2동,14439,8277,1.74,7062,7377,0.96
794,2729055000,대구광역시달서구두류3동,8266,4119,2.01,4010,4256,0.94
795,2729055500,대구광역시달서구감삼동,26706,11542,2.31,13014,13692,0.95
796,2729056300,대구광역시달서구죽전동,13595,6903,1.97,6732,6863,0.98
797,2729056800,대구광역시달서구장기동,17148,7196,2.38,8436,8712,0.97
798,2729057100,대구광역시달서구용산1동,30945,12500,2.48,15516,15429,1.01
799,2729057200,대구광역시달서구용산2동,28819,11455,2.52,14495,14324,1.01
800,2729057600,대구광역시달서구이곡1동,23115,9301,2.49,11606,11509,1.01
801,2729057700,대구광역시달서구이곡2동,16490,7114,2.32,8349,8141,1.03
802,2729058500,대구광역시달서구신당동,31686,17357,1.83,16297,15389,1.06
803,2729059000,대구광역시달서구본리동,20954,8389,2.5,10321,10633,0.97
804,2729060100,대구광역시달서구월성1동,37401,11904,3.14,18310,19091,0.96
805,2729060200,대구광역시달서구월성2동,15954,8508,1.88,7632,8322,0.92
806,2729061500,대구광역시달서구진천동,51646,20961,2.46,25304,26342,0.96
807,2729061700,대구광역시달서구유천동,31789,10220,3.11,15625,16164,0.97
808,2729062400,대구광역시달서구상인1동,36263,13161,2.76,17742,18521,0.96
809,2729062500,대구광역시달서구상인2동,19826,9374,2.11,9831,9995,0.98
810,2729062600,대구광역시달서구상인3동,11167,6219,1.8,5350,5817,0.92
811,2729062800,대구광역시달서구도원동,35557,13903,2.56,17211,18346,0.94
812,2729063000,대구광역시달서구송현1동,19383,10288,1.88,9571,9812,0.98
813,2729064000,대구광역시달서구송현2동,18132,9400,1.93,8698,9434,0.92
814,2729065000,대구광역시달서구본동,12390,6151,2.01,6114,6276,0.97
815,2771000000,대구광역시달성군,262451,111398,2.36,133149,129302,1.03
816,2771025000,대구광역시달성군화원읍,47025,19227,2.45,23342,23683,0.99
817,2771025300,대구광역시달성군논공읍,4779,2456,1.95,2578,2201,1.17
818,2771025400,대구광역시달성군논공읍공단출장소,13167,6467,2.04,6996,6171,1.13
819,2771025600,대구광역시달성군다사읍,51020,19521,2.61,25177,25843,0.97
820,2771025700,대구광역시달성군다사읍서재출장소,38307,14549,2.63,19469,18838,1.03
821,2771025900,대구광역시달성군유가읍,29542,11302,2.61,14989,14553,1.03
822,2771026200,대구광역시달성군옥포읍,25232,11237,2.25,12729,12503,1.02
823,2771026500,대구광역시달성군현풍읍,23050,11925,1.93,12117,10933,1.11
824,2771031000,대구광역시달성군가창면,7783,3769,2.07,3870,3913,0.99
825,2771033000,대구광역시달성군하빈면,3596,2030,1.77,1941,1655,1.17
826,2771038000,대구광역시달성군구지면,18950,8915,2.13,9941,9009,1.1
827,2800000000,인천광역시,2948375,1298647,2.27,1476373,1472002,1.0
828,2811000000,인천광역시중구,143633,71061,2.02,74679,68954,1.08
829,2811052000,인천광역시중구연안동,6145,3392,1.81,3326,2819,1.18
830,2811053000,인천광역시중구신포동,5086,2730,1.86,2595,2491,1.04
831,2811054000,인천광역시중구신흥동,13241,6297,2.1,6734,6507,1.03
832,2811056000,인천광역시중구도원동,3925,2073,1.89,2001,1924,1.04
833,2811057000,인천광역시중구율목동,3192,1819,1.75,1644,1548,1.06
834,2811058500,인천광역시중구동인천동,5818,3415,1.7,3083,2735,1.13
835,2811061500,인천광역시중구개항동,7022,3645,1.93,3518,3504,1.0
836,2811062000,인천광역시중구영종동,19131,10097,1.89,10455,8676,1.21
837,2811062200,인천광역시중구영종1동,44046,16826,2.62,22118,21928,1.01
838,2811062800,인천광역시중구운서동,32080,18171,1.77,17008,15072,1.13
839,2811063000,인천광역시중구용유동,3947,2596,1.52,2197,1750,1.26
840,2811400000,인천광역시중구영종출장소,0,0,0.0,0,0,0.0
841,2811800000,인천광역시중구용유출장소,0,0,0.0,0,0,0.0
842,2814000000,인천광역시동구,61486,28681,2.14,30998,30488,1.02
843,2814051000,인천광역시동구만석동,6940,3229,2.15,3580,3360,1.07
844,2814052500,인천광역시동구화수1.화평동,5929,2849,2.08,3019,2910,1.04
845,2814053000,인천광역시동구화수2동,7597,3728,2.04,3727,3870,0.96
846,2814055500,인천광역시동구송현1.2동,10394,4440,2.34,5080,5314,0.96
847,2814057000,인천광역시동구송현3동,3561,1936,1.84,1846,1715,1.08
848,2814058000,인천광역시동구송림1동,1571,698,2.25,764,807,0.95
849,2814059000,인천광역시동구송림2동,2722,1545,1.76,1403,1319,1.06
850,2814060500,인천광역시동구송림3.5동,7529,3501,2.15,3850,3679,1.05
851,2814061000,인천광역시동구송림4동,6132,2581,2.38,3176,2956,1.07
852,2814063000,인천광역시동구송림6동,6203,2637,2.35,3105,3098,1.0
853,2814064000,인천광역시동구금창동,2908,1537,1.89,1448,1460,0.99
854,2817700000,인천광역시미추홀구,407464,193561,2.11,205283,202181,1.02
855,2817751000,인천광역시미추홀구숭의2동,14726,7004,2.1,7424,7302,1.02
856,2817752000,인천광역시미추홀구숭의1.3동,13855,6771,2.05,6900,6955,0.99
857,2817753000,인천광역시미추홀구숭의4동,16409,7882,2.08,8237,8172,1.01
858,2817754000,인천광역시미추홀구용현1.4동,17411,10523,1.65,9471,7940,1.19
859,2817755000,인천광역시미추홀구용현2동,17948,8519,2.11,9006,8942,1.01
860,2817756000,인천광역시미추홀구용현3동,7642,4414,1.73,4051,3591,1.13
861,2817757000,인천광역시미추홀구용현5동,47690,20171,2.36,23646,24044,0.98
862,2817758000,인천광역시미추홀구학익1동,32105,12927,2.48,15995,16110,0.99
863,2817759000,인천광역시미추홀구학익2동,18265,8072,2.26,8956,9309,0.96
864,2817760000,인천광역시미추홀구도화1동,23296,11206,2.08,11636,11660,1.0
865,2817761000,인천광역시미추홀구도화2.3동,33023,14587,2.26,16792,16231,1.03
866,2817762000,인천광역시미추홀구주안1동,20533,11922,1.72,10784,9749,1.11
867,2817763000,인천광역시미추홀구주안2동,16785,8442,1.99,8460,8325,1.02
868,2817764000,인천광역시미추홀구주안3동,8762,4470,1.96,4459,4303,1.04
869,2817765000,인천광역시미추홀구주안4동,13460,7052,1.91,6752,6708,1.01
870,2817766000,인천광역시미추홀구주안5동,20674,10199,2.03,10358,10316,1.0
871,2817767000,인천광역시미추홀구주안6동,21988,10116,2.17,10978,11010,1.0
872,2817768000,인천광역시미추홀구주안7동,12524,6071,2.06,6094,6430,0.95
873,2817769000,인천광역시미추홀구주안8동,20995,9351,2.25,10240,10755,0.95
874,2817770000,인천광역시미추홀구관교동,15123,6326,2.39,7387,7736,0.95
875,2817771000,인천광역시미추홀구문학동,14250,7536,1.89,7657,6593,1.16
876,2818500000,인천광역시연수구,389644,155984,2.5,193417,196227,0.99
877,2818563000,인천광역시연수구옥련1동,19332,8292,2.33,9569,9763,0.98
878,2818564000,인천광역시연수구옥련2동,20365,7971,2.55,10043,10322,0.97
879,2818575000,인천광역시연수구선학동,17176,8205,2.09,8888,8288,1.07
880,2818576100,인천광역시연수구연수1동,19404,9810,1.98,10624,8780,1.21
881,2818576200,인천광역시연수구연수2동,21168,9887,2.14,10402,10766,0.97
882,2818576300,인천광역시연수구연수3동,16112,7462,2.16,7645,8467,0.9
883,2818576600,인천광역시연수구청학동,24815,12682,1.96,12866,11949,1.08
884,2818578000,인천광역시연수구동춘1동,25462,9299,2.74,12522,12940,0.97
885,2818579000,인천광역시연수구동춘2동,18328,7003,2.62,8899,9429,0.94
886,2818579500,인천광역시연수구동춘3동,18558,5833,3.18,9027,9531,0.95
887,2818582000,인천광역시연수구송도1동,37659,14547,2.59,18448,19211,0.96
888,2818583000,인천광역시연수구송도2동,36729,11831,3.1,18030,18699,0.96
889,2818584000,인천광역시연수구송도3동,49052,18832,2.6,24053,24999,0.96
890,2818585000,인천광역시연수구송도4동,25468,9380,2.72,12603,12865,0.98
891,2818586000,인천광역시연수구송도5동,40016,14950,2.68,19798,20218,0.98
892,2820000000,인천광역시남동구,518272,228442,2.27,257468,260804,0.99
893,2820051000,인천광역시남동구구월1동,31445,13181,2.39,15295,16150,0.95
894,2820052000,인천광역시남동구구월2동,35508,12772,2.78,17473,18035,0.97
895,2820052100,인천광역시남동구구월3동,30158,17430,1.73,15049,15109,1.0
896,2820052200,인천광역시남동구구월4동,14630,7806,1.87,7391,7239,1.02
897,2820053000,인천광역시남동구간석1동,21199,10384,2.04,10457,10742,0.97
898,2820054000,인천광역시남동구간석2동,21965,9441,2.33,10963,11002,1.0
899,2820055000,인천광역시남동구간석3동,27576,13121,2.1,13738,13838,0.99
900,2820055100,인천광역시남동구간석4동,29093,13452,2.16,14529,14564,1.0
901,2820056000,인천광역시남동구만수1동,17128,9023,1.9,8359,8769,0.95
902,2820057000,인천광역시남동구만수2동,24289,9870,2.46,11903,12386,0.96
903,2820058000,인천광역시남동구만수3동,17709,7438,2.38,8959,8750,1.02
904,2820058100,인천광역시남동구만수4동,21056,9166,2.3,10283,10773,0.95
905,2820058200,인천광역시남동구만수5동,15307,7646,2.0,7624,7683,0.99
906,2820058300,인천광역시남동구만수6동,24342,10319,2.36,11809,12533,0.94
907,2820065000,인천광역시남동구장수서창동,19919,7987,2.49,9921,9998,0.99
908,2820065500,인천광역시남동구서창2동,39527,15837,2.5,19636,19891,0.99
909,2820066000,인천광역시남동구남촌도림동,21097,9306,2.27,10822,10275,1.05
910,2820069000,인천광역시남동구논현1동,32014,13475,2.38,16151,15863,1.02
911,2820070000,인천광역시남동구논현2동,32974,15094,2.18,16670,16304,1.02
912,2820071000,인천광역시남동구논현고잔동,41336,15694,2.63,20436,20900,0.98
913,2823700000,인천광역시부평구,486765,213372,2.28,240348,246417,0.98
914,2823751000,인천광역시부평구부평1동,36682,16748,2.19,17662,19020,0.93
915,2823752000,인천광역시부평구부평2동,14921,7205,2.07,7441,7480,0.99
916,2823753000,인천광역시부평구부평3동,12746,6300,2.02,6353,6393,0.99
917,2823754000,인천광역시부평구부평4동,36983,18607,1.99,18276,18707,0.98
918,2823755000,인천광역시부평구부평5동,31745,15476,2.05,15644,16101,0.97
919,2823756000,인천광역시부평구부평6동,14975,7285,2.06,7375,7600,0.97
920,2823757000,인천광역시부평구산곡1동,11697,5466,2.14,5892,5805,1.01
921,2823758000,인천광역시부평구산곡2동,31200,11022,2.83,15363,15837,0.97
922,2823758100,인천광역시부평구산곡3동,22079,8867,2.49,10713,11366,0.94
923,2823758200,인천광역시부평구산곡4동,17762,6679,2.66,8489,9273,0.92
924,2823759100,인천광역시부평구청천1동,6913,3466,1.99,3709,3204,1.16
925,2823759200,인천광역시부평구청천2동,35302,14595,2.42,17630,17672,1.0
926,2823764100,인천광역시부평구갈산1동,16570,7373,2.25,8399,8171,1.03
927,2823764200,인천광역시부평구갈산2동,18724,8240,2.27,9088,9636,0.94
928,2823764600,인천광역시부평구삼산1동,33290,13975,2.38,16284,17006,0.96
929,2823764800,인천광역시부평구삼산2동,28818,10288,2.8,13953,14865,0.94
930,2823765000,인천광역시부평구부개1동,16165,7750,2.09,8115,8050,1.01
931,2823766000,인천광역시부평구부개2동,20059,8385,2.39,9814,10245,0.96
932,2823766100,인천광역시부평구부개3동,30754,12442,2.47,14788,15966,0.93
933,2823767000,인천광역시부평구일신동,12565,5228,2.4,6412,6153,1.04
934,2823768000,인천광역시부평구십정1동,13933,6374,2.19,7072,6861,1.03
935,2823769000,인천광역시부평구십정2동,22882,11601,1.97,11876,11006,1.08
936,2824500000,인천광역시계양구,295696,127984,2.31,147316,148380,0.99
937,2824560100,인천광역시계양구효성1동,27361,11625,2.35,13726,13635,1.01
938,2824560200,인천광역시계양구효성2동,28995,11724,2.47,14677,14318,1.03
939,2824561100,인천광역시계양구계산1동,19230,10034,1.92,10138,9092,1.12
940,2824561200,인천광역시계양구계산2동,15790,7869,2.01,7852,7938,0.99
941,2824561300,인천광역시계양구계산3동,19091,8630,2.21,9143,9948,0.92
942,2824561400,인천광역시계양구계산4동,23166,9185,2.52,11697,11469,1.02
943,2824562100,인천광역시계양구작전1동,27815,11279,2.47,13633,14182,0.96
944,2824562200,인천광역시계양구작전2동,19816,9143,2.17,9783,10033,0.98
945,2824564000,인천광역시계양구작전서운동,34996,14204,2.46,17424,17572,0.99
946,2824571000,인천광역시계양구계양1동,20887,8571,2.44,10342,10545,0.98
947,2824572000,인천광역시계양구계양2동,33090,15682,2.11,16355,16735,0.98
948,2824573000,인천광역시계양구계양3동,25459,10038,2.54,12546,12913,0.97
949,2826000000,인천광역시서구,555380,232834,2.39,280398,274982,1.02
950,2826051500,인천광역시서구검암경서동,45483,19773,2.3,23207,22276,1.04
951,2826053000,인천광역시서구연희동,40677,19054,2.13,20729,19948,1.04
952,2826053600,인천광역시서구청라1동,31513,11943,2.64,15713,15800,0.99
953,2826053700,인천광역시서구청라2동,48916,18069,2.71,24270,24646,0.98
954,2826053900,인천광역시서구청라3동,31609,11193,2.82,15650,15959,0.98
955,2826054200,인천광역시서구가정1동,28007,12006,2.33,14059,13948,1.01
956,2826054300,인천광역시서구가정2동,6505,3036,2.14,3393,3112,1.09
957,2826054400,인천광역시서구가정3동,9616,4406,2.18,4811,4805,1.0
958,2826055000,인천광역시서구석남1동,22322,10922,2.04,11493,10829,1.06
959,2826056000,인천광역시서구석남2동,13044,6239,2.09,6771,6273,1.08
960,2826056100,인천광역시서구석남3동,13825,6608,2.09,7011,6814,1.03
961,2826057500,인천광역시서구신현원창동,31643,13008,2.43,15810,15833,1.0
962,2826058000,인천광역시서구가좌1동,12442,6190,2.01,6615,5827,1.14
963,2826059000,인천광역시서구가좌2동,19994,7765,2.57,9750,10244,0.95
964,2826060000,인천광역시서구가좌3동,16604,8046,2.06,8446,8158,1.04
965,2826061000,인천광역시서구가좌4동,10502,4940,2.13,5439,5063,1.07
966,2826068000,인천광역시서구검단동,32853,14702,2.23,16973,15880,1.07
967,2826069000,인천광역시서구불로대곡동,22596,9193,2.46,11506,11090,1.04
968,2826070000,인천광역시서구원당동,23987,9668,2.48,12143,11844,1.03
969,2826071000,인천광역시서구당하동,27799,10859,2.56,13838,13961,0.99
970,2826072000,인천광역시서구오류왕길동,25551,10316,2.48,13022,12529,1.04
971,2826073000,인천광역시서구마전동,22801,8301,2.75,11232,11569,0.97
972,2826074000,인천광역시서구아라동,17091,6597,2.59,8517,8574,0.99
973,2826500000,인천광역시서구검단출장소,0,0,0.0,0,0,0.0
974,2871000000,인천광역시강화군,69693,34667,2.01,34868,34825,1.0
975,2871025000,인천광역시강화군강화읍,22780,10638,2.14,11250,11530,0.98
976,2871031000,인천광역시강화군선원면,7959,3615,2.2,3957,4002,0.99
977,2871032000,인천광역시강화군불은면,4929,2621,1.88,2473,2456,1.01
978,2871033000,인천광역시강화군길상면,7197,3608,1.99,3615,3582,1.01
979,2871034000,인천광역시강화군화도면,4563,2443,1.87,2314,2249,1.03
980,2871035000,인천광역시강화군양도면,4301,2188,1.97,2161,2140,1.01
981,2871036000,인천광역시강화군내가면,3060,1654,1.85,1499,1561,0.96
982,2871037000,인천광역시강화군하점면,4034,2077,1.94,2065,1969,1.05
983,2871038000,인천광역시강화군양사면,1885,1001,1.88,932,953,0.98
984,2871039000,인천광역시강화군송해면,3289,1664,1.98,1643,1646,1.0
985,2871040000,인천광역시강화군교동면,2853,1559,1.83,1472,1381,1.07
986,2871041000,인천광역시강화군삼산면,2192,1208,1.81,1139,1053,1.08
987,2871042000,인천광역시강화군서도면,387,220,1.76,201,186,1.08
988,2871042500,인천광역시강화군서도면볼음출장소,264,171,1.54,147,117,1.26
989,2872000000,인천광역시옹진군,20342,12061,1.69,11598,8744,1.33
990,2872031000,인천광역시옹진군북도면,1166,664,1.76,610,556,1.1
991,2872031500,인천광역시옹진군북도면장봉출장소,985,528,1.87,525,460,1.14
992,2872033000,인천광역시옹진군백령면,4969,2926,1.7,2927,2042,1.43
993,2872034000,인천광역시옹진군대청면,1179,721,1.64,676,503,1.34
994,2872034500,인천광역시옹진군대청면소청출장소,220,171,1.29,137,83,1.65
995,2872035000,인천광역시옹진군덕적면,1894,1159,1.63,1034,860,1.2
996,2872036000,인천광역시옹진군영흥면,6561,3673,1.79,3671,2890,1.27
997,2872037000,인천광역시옹진군자월면,947,563,1.68,509,438,1.16
998,2872037500,인천광역시옹진군자월면이작출장소,373,228,1.64,194,179,1.08
999,2872038000,인천광역시옹진군연평면,2048,1428,1.43,1315,733,1.79
1000,2900000000,광주광역시,1441611,645712,2.23,713015,728596,0.98
1001,2911000000,광주광역시동구,103470,52362,1.98,51046,52424,0.97
1002,2911052500,광주광역시동구충장동,4642,3522,1.32,2362,2280,1.04
1003,2911054500,광주광역시동구동명동,3890,2497,1.56,1965,1925,1.02
1004,2911056000,광주광역시동구계림1동,11009,6016,1.83,5725,5284,1.08
1005,2911057000,광주광역시동구계림2동,9818,4151,2.37,4774,5044,0.95
1006,2911059000,광주광역시동구산수1동,8579,4503,1.91,4300,4279,1.0
1007,2911060000,광주광역시동구산수2동,10501,4865,2.16,5100,5401,0.94
1008,2911062000,광주광역시동구지산1동,4249,2429,1.75,2146,2103,1.02
1009,2911063000,광주광역시동구지산2동,4567,2438,1.87,2333,2234,1.04
1010,2911065500,광주광역시동구서남동,3056,2227,1.37,1632,1424,1.15
1011,2911068500,광주광역시동구학동,7724,3625,2.13,3673,4051,0.91
1012,2911071000,광주광역시동구학운동,11445,5234,2.19,5394,6051,0.89
1013,2911073000,광주광역시동구지원1동,7833,3651,2.15,3793,4040,0.94
1014,2911074000,광주광역시동구지원2동,16157,7204,2.24,7849,8308,0.94
1015,2914000000,광주광역시서구,291231,132808,2.19,142721,148510,0.96
1016,2914057500,광주광역시서구양동,3686,2121,1.74,1848,1838,1.01
1017,2914059000,광주광역시서구양3동,4578,2174,2.11,2218,2360,0.94
1018,2914065000,광주광역시서구농성1동,11008,6218,1.77,5435,5573,0.98
1019,2914066000,광주광역시서구농성2동,4900,2944,1.66,2571,2329,1.1
1020,2914073000,광주광역시서구광천동,8084,4234,1.91,4155,3929,1.06
1021,2914074000,광주광역시서구유덕동,10975,4898,2.24,5601,5374,1.04
1022,2914074500,광주광역시서구치평동,30293,13617,2.22,14476,15817,0.92
1023,2914075100,광주광역시서구상무1동,24802,12183,2.04,12415,12387,1.0
1024,2914075200,광주광역시서구상무2동,23861,13083,1.82,11646,12215,0.95
1025,2914076000,광주광역시서구화정1동,15542,8494,1.83,7397,8145,0.91
1026,2914077000,광주광역시서구화정2동,20604,8006,2.57,10308,10296,1.0
1027,2914078000,광주광역시서구화정3동,10068,4625,2.18,4964,5104,0.97
1028,2914079000,광주광역시서구화정4동,15428,6508,2.37,7422,8006,0.93
1029,2914080000,광주광역시서구서창동,5792,2698,2.15,2994,2798,1.07
1030,2914082100,광주광역시서구금호1동,20012,8816,2.27,9506,10506,0.9
1031,2914082400,광주광역시서구금호2동,28572,10554,2.71,13971,14601,0.96
1032,2914083000,광주광역시서구풍암동,36781,15243,2.41,18097,18684,0.97
1033,2914084000,광주광역시서구동천동,16245,6392,2.54,7697,8548,0.9
1034,2915500000,광주광역시남구,215575,95722,2.25,103542,112033,0.92
1035,2915551000,광주광역시남구양림동,7018,3166,2.22,3211,3807,0.84
1036,2915552000,광주광역시남구방림1동,6641,2930,2.27,3169,3472,0.91
1037,2915553000,광주광역시남구방림2동,8912,4082,2.18,4207,4705,0.89
1038,2915553700,광주광역시남구봉선1동,13466,6665,2.02,6310,7156,0.88
1039,2915553800,광주광역시남구봉선2동,28800,9990,2.88,13461,15339,0.88
1040,2915554500,광주광역시남구사직동,5215,2961,1.76,2689,2526,1.06
1041,2915560500,광주광역시남구월산동,8836,4583,1.93,4531,4305,1.05
1042,2915563000,광주광역시남구월산4동,8478,4779,1.77,4366,4112,1.06
1043,2915564000,광주광역시남구월산5동,6414,3528,1.82,3197,3217,0.99
1044,2915567000,광주광역시남구백운1동,12208,5182,2.36,5752,6456,0.89
1045,2915568000,광주광역시남구백운2동,6373,3336,1.91,3137,3236,0.97
1046,2915569000,광주광역시남구주월1동,21920,9620,2.28,10608,11312,0.94
1047,2915570000,광주광역시남구주월2동,8023,4040,1.99,3985,4038,0.99
1048,2915570500,광주광역시남구진월동,29383,11487,2.56,13696,15687,0.87
1049,2915571000,광주광역시남구효덕동,16133,7501,2.15,7734,8399,0.92
1050,2915572000,광주광역시남구송암동,21450,8580,2.5,10368,11082,0.94
1051,2915573000,광주광역시남구대촌동,6305,3292,1.92,3121,3184,0.98
1052,2917000000,광주광역시북구,427114,195695,2.18,211999,215115,0.99
1053,2917051000,광주광역시북구중흥1동,4784,3000,1.59,2478,2306,1.07
1054,2917052000,광주광역시북구중흥2동,6867,3779,1.82,3506,3361,1.04
1055,2917053000,광주광역시북구중흥3동,4809,2851,1.69,2535,2274,1.11
1056,2917055500,광주광역시북구중앙동,3085,2049,1.51,1661,1424,1.17
1057,2917057000,광주광역시북구임동,9157,4476,2.05,4519,4638,0.97
1058,2917058000,광주광역시북구신안동,12379,7227,1.71,6515,5864,1.11
1059,2917059000,광주광역시북구용봉동,38542,17773,2.17,19207,19335,0.99
1060,2917060100,광주광역시북구운암1동,19356,7441,2.6,9364,9992,0.94
1061,2917060200,광주광역시북구운암2동,12033,6102,1.97,6063,5970,1.02
1062,2917060300,광주광역시북구운암3동,12663,5077,2.49,6061,6602,0.92
1063,2917061500,광주광역시북구동림동,23375,9878,2.37,11502,11873,0.97
1064,2917062000,광주광역시북구우산동,10290,5643,1.82,4990,5300,0.94
1065,2917063500,광주광역시북구풍향동,5738,2774,2.07,2868,2870,1.0
1066,2917065000,광주광역시북구문화동,20918,9736,2.15,10293,10625,0.97
1067,2917065600,광주광역시북구문흥1동,15983,6483,2.47,7756,8227,0.94
1068,2917065700,광주광역시북구문흥2동,15707,7349,2.14,7473,8234,0.91
1069,2917066100,광주광역시북구두암1동,7773,4021,1.93,3872,3901,0.99
1070,2917066200,광주광역시북구두암2동,16037,7676,2.09,7926,8111,0.98
1071,2917066300,광주광역시북구두암3동,13400,7816,1.71,6434,6966,0.92
1072,2917066600,광주광역시북구삼각동,14116,6068,2.33,7270,6846,1.06
1073,2917066900,광주광역시북구일곡동,29944,11545,2.59,14666,15278,0.96
1074,2917067300,광주광역시북구매곡동,13842,5489,2.52,6775,7067,0.96
1075,2917067600,광주광역시북구오치1동,10940,5529,1.98,5549,5391,1.03
1076,2917067700,광주광역시북구오치2동,12523,7005,1.79,6121,6402,0.96
1077,2917068500,광주광역시북구석곡동,2519,1398,1.8,1309,1210,1.08
1078,2917069500,광주광역시북구건국동,22423,9282,2.42,11352,11071,1.03
1079,2917069600,광주광역시북구양산동,37958,16393,2.32,19080,18878,1.01
1080,2917069700,광주광역시북구신용동,29953,11835,2.53,14854,15099,0.98
1081,2920000000,광주광역시광산구,404221,169125,2.39,203707,200514,1.02
1082,2920051500,광주광역시광산구송정1동,10863,4879,2.23,5517,5346,1.03
1083,2920052500,광주광역시광산구송정2동,6558,3483,1.88,3267,3291,0.99
1084,2920054000,광주광역시광산구도산동,15279,6682,2.29,7720,7559,1.02
1085,2920055000,광주광역시광산구신흥동,4594,2056,2.23,2327,2267,1.03
1086,2920056500,광주광역시광산구어룡동,33035,14009,2.36,16891,16144,1.05
1087,2920058000,광주광역시광산구우산동,28905,14708,1.97,14684,14221,1.03
1088,2920060000,광주광역시광산구월곡1동,10884,4962,2.19,5532,5352,1.03
1089,2920061000,광주광역시광산구월곡2동,15594,6644,2.35,7857,7737,1.02
1090,2920062000,광주광역시광산구비아동,7481,3480,2.15,3965,3516,1.13
1091,2920062400,광주광역시광산구첨단1동,27459,10441,2.63,13632,13827,0.99
1092,2920062600,광주광역시광산구첨단2동,43297,18410,2.35,21827,21470,1.02
1093,2920063000,광주광역시광산구신가동,18457,6973,2.65,9365,9092,1.03
1094,2920063500,광주광역시광산구운남동,30856,12313,2.51,15101,15755,0.96
1095,2920063700,광주광역시광산구수완동,77438,28302,2.74,38146,39292,0.97
1096,2920064000,광주광역시광산구하남동,26266,10495,2.5,13542,12724,1.06
1097,2920065000,광주광역시광산구임곡동,2139,1273,1.68,1102,1037,1.06
1098,2920066000,광주광역시광산구동곡동,1856,1058,1.75,950,906,1.05
1099,2920067000,광주광역시광산구평동,4064,2522,1.61,2266,1798,1.26
1100,2920068000,광주광역시광산구삼도동,2199,1335,1.65,1148,1051,1.09
1101,2920069000,광주광역시광산구본량동,2009,1228,1.64,1005,1004,1.0
1102,2920070000,광주광역시광산구신창동,34988,13872,2.52,17863,17125,1.04
1103,3000000000,대전광역시,1452251,664417,2.19,724626,727625,1.0
1104,3011000000,대전광역시동구,222222,107832,2.06,111953,110269,1.02
1105,3011051500,대전광역시동구중앙동,4545,3124,1.45,2546,1999,1.27
1106,3011053000,대전광역시동구효동,24722,9638,2.57,12149,12573,0.97
1107,3011054500,대전광역시동구신인동,11997,5467,2.19,5855,6142,0.95
1108,3011055100,대전광역시동구판암1동,12393,5909,2.1,6074,6319,0.96
1109,3011055200,대전광역시동구판암2동,8517,5296,1.61,4151,4366,0.95
1110,3011056000,대전광역시동구용운동,21942,10281,2.13,11053,10889,1.02
1111,3011058500,대전광역시동구대동,14919,6417,2.32,7469,7450,1.0
1112,3011059000,대전광역시동구자양동,10652,6444,1.65,5626,5026,1.12
1113,3011062000,대전광역시동구가양1동,13687,6981,1.96,7038,6649,1.06
1114,3011063000,대전광역시동구가양2동,18244,8921,2.05,9152,9092,1.01
1115,3011064000,대전광역시동구용전동,20496,11453,1.79,10522,9974,1.05
1116,3011066500,대전광역시동구성남동,11954,5636,2.12,5941,6013,0.99
1117,3011067000,대전광역시동구홍도동,11065,5814,1.9,5598,5467,1.02
1118,3011069500,대전광역시동구삼성동,14088,6657,2.12,7170,6918,1.04
1119,3011072500,대전광역시동구대청동,2415,1265,1.91,1252,1163,1.08
1120,3011074000,대전광역시동구산내동,20586,8529,2.41,10357,10229,1.01
1121,3014000000,대전광역시중구,230341,107609,2.14,113507,116834,0.97
1122,3014053500,대전광역시중구은행선화동,15644,9200,1.7,8034,7610,1.06
1123,3014055000,대전광역시중구목동,14379,4922,2.92,6880,7499,0.92
1124,3014056000,대전광역시중구중촌동,12527,5998,2.09,6084,6443,0.94
1125,3014057500,대전광역시중구대흥동,13752,7520,1.83,6815,6937,0.98
1126,3014060500,대전광역시중구문창동,4699,2648,1.77,2455,2244,1.09
1127,3014062000,대전광역시중구석교동,15622,7764,2.01,7859,7763,1.01
1128,3014063000,대전광역시중구대사동,5474,3262,1.68,2652,2822,0.94
1129,3014064000,대전광역시중구부사동,6748,3509,1.92,3406,3342,1.02
1130,3014065500,대전광역시중구용두동,9465,5129,1.85,4585,4880,0.94
1131,3014067000,대전광역시중구오류동,10577,4979,2.12,4980,5597,0.89
1132,3014068000,대전광역시중구태평1동,13291,5217,2.55,6446,6845,0.94
1133,3014069000,대전광역시중구태평2동,25613,9611,2.66,12313,13300,0.93
1134,3014070000,대전광역시중구유천1동,6555,3663,1.79,3427,3128,1.1
1135,3014071000,대전광역시중구유천2동,13711,6465,2.12,6783,6928,0.98
1136,3014072000,대전광역시중구문화1동,22378,8836,2.53,10793,11585,0.93
1137,3014073000,대전광역시중구문화2동,12631,6104,2.07,6125,6506,0.94
1138,3014074000,대전광역시중구산성동,27275,12782,2.13,13870,13405,1.03
1139,3017000000,대전광역시서구,473365,213592,2.22,232714,240651,0.97
1140,3017051000,대전광역시서구복수동,22354,8792,2.54,11019,11335,0.97
1141,3017052000,대전광역시서구도마1동,15318,8111,1.89,7776,7542,1.03
1142,3017053000,대전광역시서구도마2동,17328,8305,2.09,8728,8600,1.01
1143,3017053500,대전광역시서구정림동,16123,6812,2.37,7848,8275,0.95
1144,3017054000,대전광역시서구변동,16015,7808,2.05,8138,7877,1.03
1145,3017055000,대전광역시서구용문동,12267,7150,1.72,5859,6408,0.91
1146,3017055500,대전광역시서구탄방동,27284,14566,1.87,13108,14176,0.92
1147,3017056000,대전광역시서구괴정동,19227,11407,1.69,9399,9828,0.96
1148,3017057000,대전광역시서구가장동,11775,5130,2.3,5728,6047,0.95
1149,3017057500,대전광역시서구내동,23750,9553,2.49,11352,12398,0.92
1150,3017058100,대전광역시서구갈마1동,21613,11439,1.89,11032,10581,1.04
1151,3017058200,대전광역시서구갈마2동,24860,13213,1.88,12437,12423,1.0
1152,3017058600,대전광역시서구월평1동,11234,7271,1.55,5997,5237,1.15
1153,3017058700,대전광역시서구월평2동,14706,7188,2.05,6973,7733,0.9
1154,3017058800,대전광역시서구월평3동,21196,7618,2.78,10408,10788,0.96
1155,3017059000,대전광역시서구가수원동,44248,17361,2.55,21766,22482,0.97
1156,3017059600,대전광역시서구관저1동,15563,6518,2.39,7415,8148,0.91
1157,3017059700,대전광역시서구관저2동,49843,19258,2.59,24335,25508,0.95
1158,3017060000,대전광역시서구기성동,3689,1954,1.89,1898,1791,1.06
1159,3017063000,대전광역시서구둔산1동,16784,5779,2.9,8272,8512,0.97
1160,3017064000,대전광역시서구둔산2동,35669,14407,2.48,17273,18396,0.94
1161,3017065000,대전광역시서구만년동,12758,5966,2.14,6406,6352,1.01
1162,3017066000,대전광역시서구둔산3동,19761,7986,2.47,9547,10214,0.93
1163,3020000000,대전광역시유성구,351277,155450,2.26,177463,173814,1.02
1164,3020052000,대전광역시유성구진잠동,25118,11309,2.22,12867,12251,1.05
1165,3020052600,대전광역시유성구학하동,17045,7583,2.25,8798,8247,1.07
1166,3020052700,대전광역시유성구상대동,22014,8065,2.73,10731,11283,0.95
1167,3020053000,대전광역시유성구온천1동,26734,17447,1.53,13788,12946,1.07
1168,3020054000,대전광역시유성구온천2동,40014,20033,2.0,20802,19212,1.08
1169,3020054600,대전광역시유성구노은1동,21827,8825,2.47,10843,10984,0.99
1170,3020054700,대전광역시유성구노은2동,24367,9482,2.57,11976,12391,0.97
1171,3020054800,대전광역시유성구노은3동,37318,14124,2.64,18289,19029,0.96
1172,3020055000,대전광역시유성구신성동,26086,11883,2.2,13661,12425,1.1
1173,3020057000,대전광역시유성구전민동,27016,11448,2.36,13848,13168,1.05
1174,3020058000,대전광역시유성구구즉동,27291,11855,2.3,13968,13323,1.05
1175,3020060000,대전광역시유성구관평동,28750,10749,2.67,14685,14065,1.04
1176,3020061000,대전광역시유성구원신흥동,27697,12647,2.19,13207,14490,0.91
1177,3023000000,대전광역시대덕구,175046,79934,2.19,88989,86057,1.03
1178,3023051000,대전광역시대덕구오정동,14506,7660,1.89,7698,6808,1.13
1179,3023052000,대전광역시대덕구대화동,6944,3529,1.97,3662,3282,1.12
1180,3023052500,대전광역시대덕구회덕동,12271,5663,2.17,6224,6047,1.03
1181,3023053300,대전광역시대덕구비래동,16215,7028,2.31,8068,8147,0.99
1182,3023054300,대전광역시대덕구송촌동,27150,10399,2.61,13388,13762,0.97
1183,3023054600,대전광역시대덕구중리동,19567,10330,1.89,10162,9405,1.08
1184,3023055000,대전광역시대덕구신탄진동,12825,6175,2.08,6636,6189,1.07
1185,3023056000,대전광역시대덕구석봉동,16303,6486,2.51,8347,7956,1.05
1186,3023057000,대전광역시대덕구덕암동,13725,6601,2.08,7295,6430,1.13
1187,3023058000,대전광역시대덕구목상동,6474,3185,2.03,3516,2958,1.19
1188,3023060000,대전광역시대덕구법1동,13100,6002,2.18,6186,6914,0.89
1189,3023061000,대전광역시대덕구법2동,15966,6876,2.32,7807,8159,0.96
1190,3100000000,울산광역시,1121592,482650,2.32,576217,545375,1.06
1191,3111000000,울산광역시중구,212883,93633,2.27,107736,105147,1.02
1192,3111051000,울산광역시중구학성동,11223,5862,1.91,5722,5501,1.04
1193,3111052000,울산광역시중구반구1동,16804,7850,2.14,8726,8078,1.08
1194,3111053000,울산광역시중구반구2동,8658,4312,2.01,4394,4264,1.03
1195,3111054000,울산광역시중구복산1동,4377,2038,2.15,2202,2175,1.01
1196,3111055000,울산광역시중구복산2동,11227,4788,2.34,5598,5629,0.99
1197,3111058500,울산광역시중구중앙동,12644,7057,1.79,6508,6136,1.06
1198,3111059000,울산광역시중구우정동,18222,8109,2.25,9072,9150,0.99
1199,3111060000,울산광역시중구태화동,33110,12715,2.6,16511,16599,0.99
1200,3111061000,울산광역시중구다운동,22693,10717,2.12,11560,11133,1.04
1201,3111062000,울산광역시중구병영1동,22032,9331,2.36,11188,10844,1.03
1202,3111063000,울산광역시중구병영2동,20241,8601,2.35,10184,10057,1.01
1203,3111064000,울산광역시중구약사동,10811,3814,2.83,5413,5398,1.0
1204,3111065000,울산광역시중구성안동,20841,8439,2.47,10658,10183,1.05
1205,3114000000,울산광역시남구,313819,138512,2.27,160055,153764,1.04
1206,3114051000,울산광역시남구신정1동,18204,9581,1.9,9169,9035,1.01
1207,3114052000,울산광역시남구신정2동,24176,9671,2.5,12357,11819,1.05
1208,3114053000,울산광역시남구신정3동,16386,7721,2.12,8339,8047,1.04
1209,3114054000,울산광역시남구신정4동,20901,8517,2.45,10558,10343,1.02
1210,3114055000,울산광역시남구신정5동,8867,4735,1.87,4747,4120,1.15
1211,3114056000,울산광역시남구달동,27174,13704,1.98,13706,13468,1.02
1212,3114057000,울산광역시남구삼산동,49028,23470,2.09,25492,23536,1.08
1213,3114058500,울산광역시남구삼호동,20360,9290,2.19,10400,9960,1.04
1214,3114059500,울산광역시남구무거동,31814,13369,2.38,16327,15487,1.05
1215,3114060000,울산광역시남구옥동,26351,9909,2.66,13230,13121,1.01
1216,3114062500,울산광역시남구대현동,29794,11323,2.63,14877,14917,1.0
1217,3114063500,울산광역시남구수암동,16673,6063,2.75,8339,8334,1.0
1218,3114064000,울산광역시남구선암동,14310,6039,2.37,7379,6931,1.06
1219,3114067000,울산광역시남구야음장생포동,9781,5120,1.91,5135,4646,1.11
1220,3117000000,울산광역시동구,154096,66201,2.33,80417,73679,1.09
1221,3117051000,울산광역시동구방어동,40170,18122,2.22,21602,18568,1.16
1222,3117052000,울산광역시동구일산동,5772,3159,1.83,3089,2683,1.15
1223,3117053000,울산광역시동구화정동,19473,8274,2.35,9995,9478,1.05
1224,3117054000,울산광역시동구대송동,11562,5096,2.27,6062,5500,1.1
1225,3117055000,울산광역시동구전하1동,14720,6459,2.28,7582,7138,1.06
1226,3117056000,울산광역시동구전하2동,20581,7832,2.63,10441,10140,1.03
1227,3117058000,울산광역시동구남목1동,8744,3680,2.38,4473,4271,1.05
1228,3117059000,울산광역시동구남목2동,21063,8702,2.42,11118,9945,1.12
1229,3117060000,울산광역시동구남목3동,12011,4877,2.46,6055,5956,1.02
1230,3120000000,울산광역시북구,218735,85815,2.55,113265,105470,1.07
1231,3120051000,울산광역시북구농소1동,36757,14419,2.55,18825,17932,1.05
1232,3120052000,울산광역시북구농소2동,41750,15518,2.69,21216,20534,1.03
1233,3120053000,울산광역시북구농소3동,38117,13147,2.9,19387,18730,1.04
1234,3120054000,울산광역시북구강동동,16403,6612,2.48,8410,7993,1.05
1235,3120056000,울산광역시북구효문동,29520,13017,2.27,15820,13700,1.15
1236,3120057000,울산광역시북구송정동,36399,13813,2.64,18515,17884,1.04
1237,3120058000,울산광역시북구양정동,9883,4773,2.07,5734,4149,1.38
1238,3120059000,울산광역시북구염포동,9906,4516,2.19,5358,4548,1.18
1239,3171000000,울산광역시울주군,222059,98489,2.25,114744,107315,1.07
1240,3171025000,울산광역시울주군온산읍,20345,10754,1.89,11736,8609,1.36
1241,3171025300,울산광역시울주군언양읍,28316,12318,2.3,14205,14111,1.01
1242,3171025600,울산광역시울주군온양읍,28726,12279,2.34,14937,13789,1.08
1243,3171025900,울산광역시울주군범서읍,69755,25164,2.77,35067,34688,1.01
1244,3171026200,울산광역시울주군청량읍,19113,8443,2.26,9868,9245,1.07
1245,3171026500,울산광역시울주군삼남읍,22588,11306,2.0,11653,10935,1.07
1246,3171031000,울산광역시울주군서생면,8382,4492,1.87,4519,3863,1.17
1247,3171034000,울산광역시울주군웅촌면,7714,4187,1.84,4008,3706,1.08
1248,3171036000,울산광역시울주군두동면,4277,2414,1.77,2202,2075,1.06
1249,3171037000,울산광역시울주군두서면,3111,1900,1.64,1551,1560,0.99
1250,3171038000,울산광역시울주군상북면,7968,4198,1.9,4064,3904,1.04
1251,3171040000,울산광역시울주군삼동면,1764,1034,1.71,934,830,1.13
1252,3600000000,세종특별자치시,371895,153649,2.42,185678,186217,1.0
1253,3611000000,세종특별자치시,371895,153649,2.42,185678,186217,1.0
1254,3611025000,세종특별자치시조치원읍,43262,20972,2.06,22520,20742,1.09
1255,3611031000,세종특별자치시연기면,2812,1695,1.66,1599,1213,1.32
1256,3611032000,세종특별자치시연동면,3112,1749,1.78,1636,1476,1.11
1257,3611033000,세종특별자치시부강면,6152,3382,1.82,3393,2759,1.23
1258,3611034000,세종특별자치시금남면,8975,4946,1.81,4770,4205,1.13
1259,3611035000,세종특별자치시장군면,6994,4252,1.64,4050,2944,1.38
1260,3611036000,세종특별자치시연서면,7380,3971,1.86,4042,3338,1.21
1261,3611037000,세종특별자치시전의면,5523,3033,1.82,2952,2571,1.15
1262,3611038000,세종특별자치시전동면,3368,1980,1.7,1813,1555,1.17
1263,3611039000,세종특별자치시소정면,2270,1165,1.95,1204,1066,1.13
1264,3611051000,세종특별자치시한솔동,18615,6411,2.9,9151,9464,0.97
1265,3611051500,세종특별자치시새롬동,38186,15296,2.5,18549,19637,0.94
1266,3611052000,세종특별자치시도담동,33331,14229,2.34,16051,17280,0.93
1267,3611052500,세종특별자치시해밀동,8569,3096,2.77,4192,4377,0.96
1268,3611053000,세종특별자치시아름동,23349,7785,3.0,11578,11771,0.98
1269,3611054000,세종특별자치시종촌동,29139,10861,2.68,14168,14971,0.95
1270,3611055000,세종특별자치시고운동,34171,11896,2.87,16731,17440,0.96
1271,3611055500,세종특별자치시소담동,20406,7361,2.77,10048,10358,0.97
1272,3611055600,세종특별자치시반곡동,17586,7598,2.31,8662,8924,0.97
1273,3611056000,세종특별자치시보람동,19022,6905,2.75,9302,9720,0.96
1274,3611057000,세종특별자치시대평동,11315,4375,2.59,5642,5673,0.99
1275,3611058000,세종특별자치시다정동,28358,10691,2.65,13625,14733,0.92
1276,4100000000,경기도,13565450,5841995,2.32,6827298,6738152,1.01
1277,4111000000,경기도수원시,1183714,517822,2.29,595933,587781,1.01
1278,4111100000,경기도수원시장안구,273835,118432,2.31,137861,135974,1.01
1279,4111156000,경기도수원시장안구파장동,23285,10701,2.18,11779,11506,1.02
1280,4111156600,경기도수원시장안구율천동,42174,20029,2.11,22330,19844,1.13
1281,4111157100,경기도수원시장안구정자1동,28902,10960,2.64,14208,14694,0.97
1282,4111157200,경기도수원시장안구정자2동,36046,14922,2.42,17682,18364,0.96
1283,4111157300,경기도수원시장안구정자3동,41447,14308,2.9,20698,20749,1.0
1284,4111158000,경기도수원시장안구영화동,19910,10741,1.85,10169,9741,1.04
1285,4111159100,경기도수원시장안구송죽동,19459,8936,2.18,9657,9802,0.99
1286,4111159700,경기도수원시장안구조원1동,28186,12864,2.19,14231,13955,1.02
1287,4111159800,경기도수원시장안구조원2동,18535,6516,2.84,8912,9623,0.93
1288,4111160000,경기도수원시장안구연무동,15891,8455,1.88,8195,7696,1.06
1289,4111300000,경기도수원시권선구,364136,157041,2.32,183925,180211,1.02
1290,4111352000,경기도수원시권선구세류1동,10097,4442,2.27,5069,5028,1.01
1291,4111353000,경기도수원시권선구세류2동,23648,12444,1.9,12215,11433,1.07
1292,4111354000,경기도수원시권선구세류3동,18731,9163,2.04,9443,9288,1.02
1293,4111355000,경기도수원시권선구평동,40351,16636,2.43,20418,19933,1.02
1294,4111356000,경기도수원시권선구서둔동,37982,17247,2.2,19351,18631,1.04
1295,4111365000,경기도수원시권선구구운동,24235,10753,2.25,12259,11976,1.02
1296,4111366200,경기도수원시권선구금곡동,45466,17518,2.6,22398,23068,0.97
1297,4111366400,경기도수원시권선구호매실동,46236,17286,2.67,23003,23233,0.99
1298,4111367000,경기도수원시권선구권선1동,24679,13189,1.87,12620,12059,1.05
1299,4111368000,경기도수원시권선구권선2동,48445,17314,2.8,23817,24628,0.97
1300,4111369000,경기도수원시권선구곡선동,27737,14860,1.87,14968,12769,1.17
1301,4111370000,경기도수원시권선구입북동,16529,6189,2.67,8364,8165,1.02
1302,4111500000,경기도수원시팔달구,182321,91278,2.0,91926,90395,1.02
1303,4111565000,경기도수원시팔달구매교동,5876,3305,1.78,3099,2777,1.12
1304,4111566000,경기도수원시팔달구매산동,10308,6019,1.71,5541,4767,1.16
1305,4111567000,경기도수원시팔달구고등동,20018,9477,2.11,10092,9926,1.02
1306,4111568000,경기도수원시팔달구화서1동,22497,10019,2.25,10921,11576,0.94
1307,4111569000,경기도수원시팔달구화서2동,25696,9625,2.67,12638,13058,0.97
1308,4111570000,경기도수원시팔달구지동,10633,5619,1.89,5435,5198,1.05
1309,4111571000,경기도수원시팔달구우만1동,20058,10862,1.85,9994,10064,0.99
1310,4111572000,경기도수원시팔달구우만2동,16900,7614,2.22,8500,8400,1.01
1311,4111573000,경기도수원시팔달구인계동,39870,22167,1.8,20100,19770,1.02
1312,4111574000,경기도수원시팔달구행궁동,10465,6571,1.59,5606,4859,1.15
1313,4111700000,경기도수원시영통구,363422,151071,2.41,182221,181201,1.01
1314,4111751000,경기도수원시영통구매탄1동,17612,7669,2.3,8866,8746,1.01
1315,4111752000,경기도수원시영통구매탄2동,14781,6541,2.26,7347,7434,0.99
1316,4111753000,경기도수원시영통구매탄3동,35982,15859,2.27,18656,17326,1.08
1317,4111754000,경기도수원시영통구매탄4동,21431,9466,2.26,10479,10952,0.96
1318,4111755000,경기도수원시영통구원천동,38806,18109,2.14,19645,19161,1.03
1319,4111757000,경기도수원시영통구영통1동,34785,12634,2.75,17108,17677,0.97
1320,4111758000,경기도수원시영통구영통2동,26188,13192,1.99,13855,12333,1.12
1321,4111758500,경기도수원시영통구영통3동,32527,13495,2.41,16629,15898,1.05
1322,4111759300,경기도수원시영통구망포1동,31076,10916,2.85,15662,15414,1.02
1323,4111759600,경기도수원시영통구망포2동,27872,9455,2.95,13922,13950,1.0
1324,4111760000,경기도수원시영통구광교1동,53025,22070,2.4,25928,27097,0.96
1325,4111761000,경기도수원시영통구광교2동,29337,11665,2.51,14124,15213,0.93
1326,4113000000,경기도성남시,930948,409320,2.27,461131,469817,0.98
1327,4113100000,경기도성남시수정구,235988,114620,2.06,119517,116471,1.03
1328,4113151000,경기도성남시수정구신흥1동,13436,7956,1.69,7096,6340,1.12
1329,4113152000,경기도성남시수정구신흥2동,20263,7733,2.62,9885,10378,0.95
1330,4113153000,경기도성남시수정구신흥3동,11325,6528,1.73,5986,5339,1.12
1331,4113154000,경기도성남시수정구태평1동,15395,8896,1.73,7923,7472,1.06
1332,4113155000,경기도성남시수정구태평2동,15402,7984,1.93,7759,7643,1.02
1333,4113156000,경기도성남시수정구태평3동,13336,6909,1.93,6857,6479,1.06
1334,4113156100,경기도성남시수정구태평4동,13224,6683,1.98,6698,6526,1.03
1335,4113157000,경기도성남시수정구수진1동,12388,7353,1.68,6472,5916,1.09
1336,4113158000,경기도성남시수정구수진2동,15851,7822,2.03,8018,7833,1.02
1337,4113159000,경기도성남시수정구단대동,15614,6763,2.31,7672,7942,0.97
1338,4113160000,경기도성남시수정구산성동,5372,2496,2.15,2724,2648,1.03
1339,4113161000,경기도성남시수정구양지동,9896,4376,2.26,4903,4993,0.98
1340,4113162000,경기도성남시수정구복정동,10955,6792,1.61,6109,4846,1.26
1341,4113162500,경기도성남시수정구위례동,45333,17978,2.52,22124,23209,0.95
1342,4113163000,경기도성남시수정구신촌동,4661,2041,2.28,2480,2181,1.14
1343,4113164000,경기도성남시수정구고등동,10478,4686,2.24,5199,5279,0.98
1344,4113165000,경기도성남시수정구시흥동,3059,1624,1.88,1612,1447,1.11
1345,4113300000,경기도성남시중원구,210777,100328,2.1,106772,104005,1.03
1346,4113351000,경기도성남시중원구성남동,33802,18455,1.83,17605,16197,1.09
1347,4113352500,경기도성남시중원구중앙동,12093,5940,2.04,6350,5743,1.11
1348,4113353000,경기도성남시중원구금광1동,6713,3284,2.04,3470,3243,1.07
1349,4113354000,경기도성남시중원구금광2동,25814,12426,2.08,12732,13082,0.97
1350,4113355000,경기도성남시중원구은행1동,10335,4524,2.28,5081,5254,0.97
1351,4113356000,경기도성남시중원구은행2동,23824,11185,2.13,11790,12034,0.98
1352,4113357000,경기도성남시중원구상대원1동,25256,12175,2.07,13098,12158,1.08
1353,4113358000,경기도성남시중원구상대원2동,12901,6716,1.92,6711,6190,1.08
1354,4113359000,경기도성남시중원구상대원3동,12223,6488,1.88,6385,5838,1.09
1355,4113366000,경기도성남시중원구하대원동,20520,8319,2.47,10339,10181,1.02
1356,4113367000,경기도성남시중원구도촌동,27296,10816,2.52,13211,14085,0.94
1357,4113500000,경기도성남시분당구,484183,194372,2.49,234842,249341,0.94
1358,4113551000,경기도성남시분당구분당동,25713,10276,2.5,12638,13075,0.97
1359,4113552000,경기도성남시분당구수내1동,17620,7689,2.29,8395,9225,0.91
1360,4113553000,경기도성남시분당구수내2동,10478,3204,3.27,5098,5380,0.95
1361,4113554000,경기도성남시분당구수내3동,13729,5184,2.65,6845,6884,0.99
1362,4113554500,경기도성남시분당구정자동,19296,8242,2.34,9670,9626,1.0
1363,4113555000,경기도성남시분당구정자1동,30475,13975,2.18,14339,16136,0.89
1364,4113556000,경기도성남시분당구정자2동,15413,7542,2.04,7298,8115,0.9
1365,4113557000,경기도성남시분당구정자3동,16592,6477,2.56,8045,8547,0.94
1366,4113558000,경기도성남시분당구서현1동,31856,12746,2.5,15399,16457,0.94
1367,4113559000,경기도성남시분당구서현2동,18309,6717,2.73,9052,9257,0.98
1368,4113560000,경기도성남시분당구이매1동,25273,9023,2.8,12338,12935,0.95
1369,4113561000,경기도성남시분당구이매2동,13280,4449,2.98,6471,6809,0.95
1370,4113562000,경기도성남시분당구야탑1동,17231,7675,2.25,8560,8671,0.99
1371,4113563000,경기도성남시분당구야탑2동,16423,6155,2.67,7818,8605,0.91
1372,4113564000,경기도성남시분당구야탑3동,28163,12939,2.18,13859,14304,0.97
1373,4113565000,경기도성남시분당구판교동,26442,8963,2.95,12997,13445,0.97
1374,4113565500,경기도성남시분당구삼평동,24442,9069,2.7,11890,12552,0.95
1375,4113565700,경기도성남시분당구백현동,26907,10179,2.64,12995,13912,0.93
1376,4113566200,경기도성남시분당구금곡동,27934,12314,2.27,13115,14819,0.89
1377,4113566500,경기도성남시분당구구미1동,17173,7288,2.36,8303,8870,0.94
1378,4113567000,경기도성남시분당구구미동,30543,13183,2.32,14612,15931,0.92
1379,4113568000,경기도성남시분당구운중동,30891,11083,2.79,15105,15786,0.96
1380,4115000000,경기도의정부시,463661,205792,2.25,228538,235123,0.97
1381,4115051000,경기도의정부시의정부1동,32558,20214,1.61,16694,15864,1.05
1382,4115052000,경기도의정부시의정부2동,31445,16483,1.91,15612,15833,0.99
1383,4115054500,경기도의정부시호원1동,36130,15647,2.31,17572,18558,0.95
1384,4115055500,경기도의정부시호원2동,34803,13689,2.54,16846,17957,0.94
1385,4115056100,경기도의정부시장암동,20259,8595,2.36,9701,10558,0.92
1386,4115056700,경기도의정부시신곡1동,42560,17785,2.39,20917,21643,0.97
1387,4115056800,경기도의정부시신곡2동,47622,19263,2.47,23095,24527,0.94
1388,4115057300,경기도의정부시송산1동,43420,19085,2.28,21613,21807,0.99
1389,4115057600,경기도의정부시송산2동,33524,13225,2.53,16578,16946,0.98
1390,4115057800,경기도의정부시송산3동,47014,18062,2.6,22826,24188,0.94
1391,4115058000,경기도의정부시자금동,27215,12019,2.26,13356,13859,0.96
1392,4115059500,경기도의정부시가능동,25939,12589,2.06,12993,12946,1.0
1393,4115061500,경기도의정부시흥선동,19569,9567,2.05,9954,9615,1.04
1394,4115062000,경기도의정부시녹양동,21603,9569,2.26,10781,10822,1.0
1395,4117000000,경기도안양시,547178,224620,2.44,270496,276682,0.98
1396,4117100000,경기도안양시만안구,238311,103012,2.31,119239,119072,1.0
1397,4117151000,경기도안양시만안구안양1동,12485,5238,2.38,6247,6238,1.0
1398,4117152000,경기도안양시만안구안양2동,21277,10087,2.11,10669,10608,1.01
1399,4117153000,경기도안양시만안구안양3동,16484,7489,2.2,8207,8277,0.99
1400,4117154000,경기도안양시만안구안양4동,6949,3609,1.93,3470,3479,1.0
1401,4117155000,경기도안양시만안구안양5동,10254,4922,2.08,5079,5175,0.98
1402,4117156000,경기도안양시만안구안양6동,26355,12422,2.12,13467,12888,1.04
1403,4117157000,경기도안양시만안구안양7동,15654,5885,2.66,7671,7983,0.96
1404,4117158000,경기도안양시만안구안양8동,10604,5286,2.01,5506,5098,1.08
1405,4117158100,경기도안양시만안구안양9동,17247,7234,2.38,8508,8739,0.97
1406,4117159000,경기도안양시만안구석수1동,19397,7554,2.57,9520,9877,0.96
1407,4117160000,경기도안양시만안구석수2동,31304,12741,2.46,15666,15638,1.0
1408,4117161000,경기도안양시만안구석수3동,13162,5540,2.38,6633,6529,1.02
1409,4117162100,경기도안양시만안구박달1동,14903,6995,2.13,7474,7429,1.01
1410,4117163000,경기도안양시만안구박달2동,22236,8010,2.78,11122,11114,1.0
1411,4117300000,경기도안양시동안구,308867,121608,2.54,151257,157610,0.96
1412,4117351000,경기도안양시동안구비산1동,21113,7452,2.83,10317,10796,0.96
1413,4117352000,경기도안양시동안구비산2동,13029,4624,2.82,6356,6673,0.95
1414,4117353000,경기도안양시동안구비산3동,12292,5489,2.24,6159,6133,1.0
1415,4117354000,경기도안양시동안구부흥동,16995,6388,2.66,8131,8864,0.92
1416,4117354600,경기도안양시동안구달안동,10684,5505,1.94,4828,5856,0.82
1417,4117355000,경기도안양시동안구관양1동,35843,15689,2.28,17466,18377,0.95
1418,4117356000,경기도안양시동안구관양2동,18854,8808,2.14,9567,9287,1.03
1419,4117356600,경기도안양시동안구부림동,26575,12231,2.17,12890,13685,0.94
1420,4117357000,경기도안양시동안구평촌동,14496,4975,2.91,7115,7381,0.96
1421,4117357600,경기도안양시동안구평안동,23325,8077,2.89,11343,11982,0.95
1422,4117357800,경기도안양시동안구귀인동,16607,5121,3.24,8190,8417,0.97
1423,4117358000,경기도안양시동안구호계1동,18050,6999,2.58,9071,8979,1.01
1424,4117359000,경기도안양시동안구호계2동,19722,7672,2.57,9713,10009,0.97
1425,4117360000,경기도안양시동안구호계3동,21982,8353,2.63,10999,10983,1.0
1426,4117361000,경기도안양시동안구범계동,15593,5789,2.69,7470,8123,0.92
1427,4117362000,경기도안양시동안구신촌동,12786,4504,2.84,6314,6472,0.98
1428,4117363000,경기도안양시동안구갈산동,10921,3932,2.78,5328,5593,0.95
1429,4119000000,경기도부천시,806067,347024,2.32,399484,406583,0.98
1430,4119060300,경기도부천시심곡동,63258,33377,1.9,32206,31052,1.04
1431,4119060600,경기도부천시부천동,89175,39121,2.28,44568,44607,1.0
1432,4119061000,경기도부천시중동,41054,17576,2.34,20263,20791,0.97
1433,4119074200,경기도부천시신중동,128805,54421,2.37,62203,66602,0.93
1434,4119074400,경기도부천시상동,85371,31246,2.73,41937,43434,0.97
1435,4119074600,경기도부천시대산동,81778,37076,2.21,40442,41336,0.98
1436,4119075000,경기도부천시소사본동,56200,24232,2.32,27745,28455,0.98
1437,4119079500,경기도부천시범안동,94722,37229,2.54,46354,48368,0.96
1438,4119080000,경기도부천시성곡동,82550,36363,2.27,41269,41281,1.0
1439,4119083000,경기도부천시오정동,83154,36383,2.29,42497,40657,1.05
1440,4121000000,경기도광명시,292893,119817,2.44,144384,148509,0.97
1441,4121051000,경기도광명시광명1동,149,122,1.22,82,67,1.22
1442,4121052000,경기도광명시광명2동,3188,1650,1.93,1618,1570,1.03
1443,4121054000,경기도광명시광명3동,9884,4937,2.0,4808,5076,0.95
1444,4121055000,경기도광명시광명4동,13363,6208,2.15,6546,6817,0.96
1445,4121056000,경기도광명시광명5동,13496,5769,2.34,6658,6838,0.97
1446,4121057000,경기도광명시광명6동,10477,3962,2.64,5174,5303,0.98
1447,4121058000,경기도광명시광명7동,21359,8542,2.5,10556,10803,0.98
1448,4121059000,경기도광명시철산1동,10917,3928,2.78,5410,5507,0.98
1449,4121060000,경기도광명시철산2동,5766,3119,1.85,3048,2718,1.12
1450,4121061000,경기도광명시철산3동,34822,12129,2.87,17075,17747,0.96
1451,4121062000,경기도광명시철산4동,13074,5503,2.38,6543,6531,1.0
1452,4121063100,경기도광명시하안1동,25943,9927,2.61,12945,12998,1.0
1453,4121063200,경기도광명시하안2동,13831,6563,2.11,6515,7316,0.89
1454,4121063300,경기도광명시하안3동,19994,8865,2.26,9459,10535,0.9
1455,4121063400,경기도광명시하안4동,12335,5062,2.44,5981,6354,0.94
1456,4121064000,경기도광명시소하1동,31670,11761,2.69,15424,16246,0.95
1457,4121065000,경기도광명시소하2동,28666,11565,2.48,14350,14316,1.0
1458,4121065500,경기도광명시일직동,21861,9119,2.4,11006,10855,1.01
1459,4121066000,경기도광명시학온동,2098,1086,1.93,1186,912,1.3
1460,4122000000,경기도평택시,564288,262097,2.15,293954,270334,1.09
1461,4122025000,경기도평택시팽성읍,28744,16085,1.79,15049,13695,1.1
1462,4122025300,경기도평택시안중읍,43711,19034,2.3,22599,21112,1.07
1463,4122025600,경기도평택시포승읍,24568,13919,1.77,14874,9694,1.53
1464,4122025900,경기도평택시청북읍,27127,11185,2.43,14383,12744,1.13
1465,4122031000,경기도평택시진위면,11418,6082,1.88,6312,5106,1.24
1466,4122032000,경기도평택시서탄면,3681,2015,1.83,2029,1652,1.23
1467,4122033000,경기도평택시고덕면,13311,6340,2.1,7093,6218,1.14
1468,4122034000,경기도평택시오성면,6616,3275,2.02,3560,3056,1.16
1469,4122037000,경기도평택시현덕면,5105,2733,1.87,2696,2409,1.12
1470,4122051000,경기도평택시중앙동,44195,20528,2.15,22901,21294,1.08
1471,4122052000,경기도평택시서정동,25371,12894,1.97,12949,12422,1.04
1472,4122053500,경기도평택시송탄동,21963,9501,2.31,11473,10490,1.09
1473,4122055000,경기도평택시지산동,12924,7594,1.7,7153,5771,1.24
1474,4122056000,경기도평택시송북동,22099,9592,2.3,11092,11007,1.01
1475,4122057000,경기도평택시신장1동,7079,3890,1.82,3692,3387,1.09
1476,4122058000,경기도평택시신장2동,5723,3564,1.61,2965,2758,1.08
1477,4122059000,경기도평택시신평동,22810,12617,1.81,11893,10917,1.09
1478,4122060000,경기도평택시원평동,12764,6715,1.9,6688,6076,1.1
1479,4122061000,경기도평택시통복동,4088,2471,1.65,2159,1929,1.12
1480,4122062000,경기도평택시비전1동,51458,21328,2.41,25870,25588,1.01
1481,4122063000,경기도평택시비전2동,55603,21979,2.53,27578,28025,0.98
1482,4122063500,경기도평택시용이동,26025,11031,2.36,13708,12317,1.11
1483,4122064000,경기도평택시세교동,29302,12457,2.35,14786,14516,1.02
1484,4122065000,경기도평택시동삭동,37373,15812,2.36,19255,18118,1.06
1485,4122066000,경기도평택시고덕동,21230,9456,2.25,11197,10033,1.12
1486,4122200000,경기도송탄출장소,0,0,0.0,0,0,0.0
1487,4122400000,경기도안중출장소,0,0,0.0,0,0,0.0
1488,4125000000,경기도동두천시,93592,44369,2.11,46694,46898,1.0
1489,4125051000,경기도동두천시생연1동,6940,3402,2.04,3495,3445,1.01
1490,4125052000,경기도동두천시생연2동,11901,5317,2.24,5827,6074,0.96
1491,4125053500,경기도동두천시중앙동,4932,3127,1.58,2596,2336,1.11
1492,4125055000,경기도동두천시보산동,2946,1677,1.76,1430,1516,0.94
1493,4125056500,경기도동두천시불현동,26866,12198,2.2,13185,13681,0.96
1494,4125056600,경기도동두천시송내동,25829,11329,2.28,12704,13125,0.97
1495,4125058000,경기도동두천시소요동,8899,4453,2.0,4642,4257,1.09
1496,4125060000,경기도동두천시상패동,5279,2866,1.84,2815,2464,1.14
1497,4127000000,경기도안산시,652726,292113,2.23,334646,318080,1.05
1498,4127100000,경기도안산시상록구,350668,156527,2.24,178943,171725,1.04
1499,4127151000,경기도안산시상록구일동,24691,11376,2.17,12606,12085,1.04
1500,4127151500,경기도안산시상록구이동,23874,13520,1.77,12812,11062,1.16
1501,4127152500,경기도안산시상록구사동,32603,16357,1.99,17137,15466,1.11
1502,4127153200,경기도안산시상록구사이동,32581,13231,2.46,16491,16090,1.02
1503,4127153700,경기도안산시상록구해양동,41279,15763,2.62,20790,20489,1.01
1504,4127154000,경기도안산시상록구본오1동,37238,17726,2.1,19342,17896,1.08
1505,4127155000,경기도안산시상록구본오2동,26186,11007,2.38,12989,13197,0.98
1506,4127156000,경기도안산시상록구본오3동,19572,9169,2.13,9743,9829,0.99
1507,4127157000,경기도안산시상록구부곡동,21624,9511,2.27,11108,10516,1.06
1508,4127158000,경기도안산시상록구월피동,38102,17050,2.23,19447,18655,1.04
1509,4127159000,경기도안산시상록구성포동,26272,9840,2.67,12847,13425,0.96
1510,4127160000,경기도안산시상록구반월동,17516,7703,2.27,8837,8679,1.02
1511,4127161000,경기도안산시상록구안산동,9130,4274,2.14,4794,4336,1.11
1512,4127300000,경기도안산시단원구,302058,135586,2.23,155703,146355,1.06
1513,4127351000,경기도안산시단원구와동,38243,17716,2.16,20194,18049,1.12
1514,4127352500,경기도안산시단원구고잔동,21554,10174,2.12,10787,10767,1.0
1515,4127353200,경기도안산시단원구중앙동,24506,11820,2.07,12227,12279,1.0
1516,4127353500,경기도안산시단원구호수동,43745,16171,2.71,21946,21799,1.01
1517,4127354500,경기도안산시단원구원곡동,6045,4201,1.44,3471,2574,1.35
1518,4127355500,경기도안산시단원구백운동,21344,8198,2.6,10723,10621,1.01
1519,4127356500,경기도안산시단원구신길동,22471,10097,2.23,12061,10410,1.16
1520,4127357000,경기도안산시단원구초지동,46921,20351,2.31,24090,22831,1.06
1521,4127358000,경기도안산시단원구선부1동,17672,8236,2.15,9070,8602,1.05
1522,4127359000,경기도안산시단원구선부2동,15948,8025,1.99,8620,7328,1.18
1523,4127360000,경기도안산시단원구선부3동,34549,15304,2.26,17758,16791,1.06
1524,4127361000,경기도안산시단원구대부동,9060,5293,1.71,4756,4304,1.11
1525,4128000000,경기도고양시,1079353,456852,2.36,528094,551259,0.96
1526,4128100000,경기도고양시덕양구,482927,210486,2.29,238375,244552,0.97
1527,4128151000,경기도고양시덕양구주교동,14463,7171,2.02,7456,7007,1.06
1528,4128152000,경기도고양시덕양구원신동,23609,9540,2.47,11296,12313,0.92
1529,4128153000,경기도고양시덕양구흥도동,48468,20856,2.32,23416,25052,0.93
1530,4128154000,경기도고양시덕양구성사1동,21801,10162,2.15,10863,10938,0.99
1531,4128155000,경기도고양시덕양구성사2동,11343,4839,2.34,5494,5849,0.94
1532,4128156000,경기도고양시덕양구효자동,15329,6615,2.32,7477,7852,0.95
1533,4128157500,경기도고양시덕양구삼송동,25416,11201,2.27,12218,13198,0.93
1534,4128158000,경기도고양시덕양구창릉동,23536,10322,2.28,11697,11839,0.99
1535,4128159000,경기도고양시덕양구고양동,29761,12694,2.34,14971,14790,1.01
1536,4128160000,경기도고양시덕양구관산동,36505,16708,2.18,18514,17991,1.03
1537,4128161000,경기도고양시덕양구능곡동,15346,6777,2.26,7886,7460,1.06
1538,4128162100,경기도고양시덕양구화정1동,37403,16178,2.31,18191,19212,0.95
1539,4128162200,경기도고양시덕양구화정2동,32732,13133,2.49,15903,16829,0.94
1540,4128163000,경기도고양시덕양구행주동,18690,9874,1.89,9793,8897,1.1
1541,4128164000,경기도고양시덕양구행신1동,21496,8846,2.43,10471,11025,0.95
1542,4128165000,경기도고양시덕양구행신2동,31715,13177,2.41,15571,16144,0.96
1543,4128165500,경기도고양시덕양구행신3동,45093,19023,2.37,21916,23177,0.95
1544,4128166000,경기도고양시덕양구화전동,27801,11897,2.34,13847,13954,0.99
1545,4128167000,경기도고양시덕양구대덕동,2420,1473,1.64,1395,1025,1.36
1546,4128500000,경기도고양시일산동구,298873,128436,2.33,145362,153511,0.95
1547,4128551000,경기도고양시일산동구식사동,37221,13271,2.8,18105,19116,0.95
1548,4128552000,경기도고양시일산동구중산동,46603,18957,2.46,22503,24100,0.93
1549,4128553000,경기도고양시일산동구정발산동,23357,10389,2.25,11286,12071,0.93
1550,4128554000,경기도고양시일산동구풍산동,38677,14616,2.65,18616,20061,0.93
1551,4128555100,경기도고양시일산동구백석1동,30310,13085,2.32,14436,15874,0.91
1552,4128555200,경기도고양시일산동구백석2동,20806,11568,1.8,10001,10805,0.93
1553,4128556000,경기도고양시일산동구마두1동,24015,8970,2.68,11561,12454,0.93
1554,4128557000,경기도고양시일산동구마두2동,16245,5927,2.74,7665,8580,0.89
1555,4128558000,경기도고양시일산동구장항1동,11399,4888,2.33,5794,5605,1.03
1556,4128559000,경기도고양시일산동구장항2동,27085,15650,1.73,13245,13840,0.96
1557,4128560000,경기도고양시일산동구고봉동,23155,11115,2.08,12150,11005,1.1
1558,4128700000,경기도고양시일산서구,297553,117930,2.52,144357,153196,0.94
1559,4128751000,경기도고양시일산서구일산1동,26987,10341,2.61,13042,13945,0.94
1560,4128752000,경기도고양시일산서구일산2동,18318,8048,2.28,9074,9244,0.98
1561,4128753000,경기도고양시일산서구일산3동,35240,12372,2.85,17066,18174,0.94
1562,4128754000,경기도고양시일산서구탄현동,51256,20186,2.54,25047,26209,0.96
1563,4128755000,경기도고양시일산서구주엽1동,27856,11083,2.51,13052,14804,0.88
1564,4128756000,경기도고양시일산서구주엽2동,28826,11866,2.43,13473,15353,0.88
1565,4128757000,경기도고양시일산서구대화동,36112,16521,2.19,17578,18534,0.95
1566,4128758000,경기도고양시일산서구송포동,21509,8249,2.61,10648,10861,0.98
1567,4128759000,경기도고양시일산서구송산동,51449,19264,2.67,25377,26072,0.97
1568,4129000000,경기도과천시,73345,27262,2.69,36092,37253,0.97
1569,4129051000,경기도과천시중앙동,10925,3976,2.75,5286,5639,0.94
1570,4129052000,경기도과천시갈현동,16891,5599,3.02,8224,8667,0.95
1571,4129053000,경기도과천시별양동,13842,5004,2.77,6707,7135,0.94
1572,4129054000,경기도과천시부림동,15002,5429,2.76,7408,7594,0.98
1573,4129055000,경기도과천시과천동,9212,4332,2.13,4815,4397,1.1
1574,4129056000,경기도과천시문원동,7473,2922,2.56,3652,3821,0.96
1575,4131000000,경기도구리시,191948,80616,2.38,95172,96776,0.98
1576,4131051000,경기도구리시갈매동,30653,12133,2.53,15161,15492,0.98
1577,4131052000,경기도구리시동구동,37266,13861,2.69,18332,18934,0.97
1578,4131053000,경기도구리시인창동,23258,9276,2.51,11358,11900,0.95
1579,4131054100,경기도구리시교문1동,16260,8482,1.92,8350,7910,1.06
1580,4131054200,경기도구리시교문2동,21817,8040,2.71,10585,11232,0.94
1581,4131057000,경기도구리시수택1동,15617,7755,2.01,7810,7807,1.0
1582,4131058000,경기도구리시수택2동,25158,11625,2.16,12514,12644,0.99
1583,4131059000,경기도구리시수택3동,21919,9444,2.32,11062,10857,1.02
1584,4136000000,경기도남양주시,733798,299156,2.45,365103,368695,0.99
1585,4136025000,경기도남양주시와부읍,60226,23199,2.6,29681,30545,0.97
1586,4136025300,경기도남양주시진접읍,93408,37895,2.46,47191,46217,1.02
1587,4136025600,경기도남양주시화도읍,104016,43308,2.4,52008,52008,1.0
1588,4136025700,경기도남양주시화도읍동부출장소,14794,6128,2.41,7443,7351,1.01
1589,4136025900,경기도남양주시진건읍,23505,10902,2.16,12230,11275,1.08
1590,4136026200,경기도남양주시오남읍,53494,21911,2.44,26872,26622,1.01
1591,4136026500,경기도남양주시퇴계원읍,28863,12029,2.4,14392,14471,0.99
1592,4136031000,경기도남양주시별내면,19511,8535,2.29,9778,9733,1.0
1593,4136034000,경기도남양주시수동면,8957,4862,1.84,4720,4237,1.11
1594,4136036000,경기도남양주시조안면,4086,2030,2.01,2110,1976,1.07
1595,4136051000,경기도남양주시호평동,57475,21856,2.63,28029,29446,0.95
1596,4136052000,경기도남양주시평내동,36620,13757,2.66,18078,18542,0.97
1597,4136053000,경기도남양주시금곡동,18448,8906,2.07,9442,9006,1.05
1598,4136054000,경기도남양주시양정동,4220,2452,1.72,2416,1804,1.34
1599,4136054500,경기도남양주시다산1동,91650,35000,2.62,44975,46675,0.96
1600,4136056500,경기도남양주시다산2동,35495,13388,2.65,17336,18159,0.95
1601,4136057000,경기도남양주시별내동,79030,32998,2.39,38402,40628,0.95
1602,4136200000,경기도풍양출장소,0,0,0.0,0,0,0.0
1603,4137000000,경기도오산시,229983,102161,2.25,119409,110574,1.08
1604,4137051000,경기도오산시중앙동,35537,14268,2.49,17837,17700,1.01
1605,4137053000,경기도오산시남촌동,20644,13924,1.48,12330,8314,1.48
1606,4137054000,경기도오산시신장동,61008,25424,2.4,30825,30183,1.02
1607,4137055000,경기도오산시세마동,31971,13014,2.46,16384,15587,1.05
1608,4137056000,경기도오산시초평동,16188,7311,2.21,8361,7827,1.07
1609,4137057000,경기도오산시대원동,64635,28220,2.29,33672,30963,1.09
1610,4139000000,경기도시흥시,512030,220421,2.32,267423,244607,1.09
1611,4139051000,경기도시흥시대야동,44791,19104,2.34,22662,22129,1.02
1612,4139052000,경기도시흥시신천동,36126,16506,2.19,18667,17459,1.07
1613,4139053100,경기도시흥시신현동,9908,4469,2.22,5193,4715,1.1
1614,4139054000,경기도시흥시은행동,56481,20946,2.7,28224,28257,1.0
1615,4139055000,경기도시흥시매화동,12096,5316,2.28,6357,5739,1.11
1616,4139057000,경기도시흥시목감동,42209,17291,2.44,21385,20824,1.03
1617,4139058100,경기도시흥시군자동,21779,9579,2.27,11393,10386,1.1
1618,4139058200,경기도시흥시월곶동,16477,7875,2.09,8575,7902,1.09
1619,4139058900,경기도시흥시정왕본동,20280,13638,1.49,12850,7430,1.73
1620,4139059100,경기도시흥시정왕1동,22300,13120,1.7,13185,9115,1.45
1621,4139059200,경기도시흥시정왕2동,32095,13960,2.3,17490,14605,1.2
1622,4139059300,경기도시흥시정왕3동,23025,11173,2.06,12984,10041,1.29
1623,4139059400,경기도시흥시정왕4동,20947,7475,2.8,10384,10563,0.98
1624,4139059600,경기도시흥시배곧1동,35587,12133,2.93,17698,17889,0.99
1625,4139059700,경기도시흥시배곧2동,35307,15212,2.32,18525,16782,1.1
1626,4139062100,경기도시흥시과림동,1918,1228,1.56,1183,735,1.61
1627,4139063000,경기도시흥시연성동,23732,9137,2.6,12123,11609,1.04
1628,4139063100,경기도시흥시장곡동,32584,12279,2.65,16450,16134,1.02
1629,4139064000,경기도시흥시능곡동,24388,9980,2.44,12095,12293,0.98
1630,4141000000,경기도군포시,268535,113205,2.37,133246,135289,0.98
1631,4141051000,경기도군포시군포1동,33573,15783,2.13,17722,15851,1.12
1632,4141052000,경기도군포시군포2동,43789,16509,2.65,21774,22015,0.99
1633,4141054000,경기도군포시산본1동,15734,8553,1.84,7938,7796,1.02
1634,4141055000,경기도군포시산본2동,26686,9971,2.68,12929,13757,0.94
1635,4141056000,경기도군포시금정동,17228,8557,2.01,8977,8251,1.09
1636,4141057000,경기도군포시재궁동,18513,8485,2.18,8771,9742,0.9
1637,4141058000,경기도군포시오금동,21395,8696,2.46,10375,11020,0.94
1638,4141059000,경기도군포시수리동,16263,7170,2.27,7746,8517,0.91
1639,4141060000,경기도군포시궁내동,20554,7008,2.93,10069,10485,0.96
1640,4141061000,경기도군포시대야동,9518,3868,2.46,4779,4739,1.01
1641,4141062000,경기도군포시광정동,24718,10431,2.37,11999,12719,0.94
1642,4141063000,경기도군포시송부동,20564,8174,2.52,10167,10397,0.98
1643,4143000000,경기도의왕시,163356,65734,2.49,81148,82208,0.99
1644,4143051000,경기도의왕시고천동,14183,6737,2.11,7183,7000,1.03
1645,4143052000,경기도의왕시부곡동,29446,12656,2.33,14973,14473,1.03
1646,4143053000,경기도의왕시오전동,39309,14780,2.66,19527,19782,0.99
1647,4143054000,경기도의왕시내손1동,20756,8282,2.51,10171,10585,0.96
1648,4143055000,경기도의왕시내손2동,22378,8141,2.75,10989,11389,0.96
1649,4143056000,경기도의왕시청계동,37284,15138,2.46,18305,18979,0.96
1650,4145000000,경기도하남시,320087,138764,2.31,160163,159924,1.0
1651,4145051000,경기도하남시천현동,7436,4186,1.78,4112,3324,1.24
1652,4145052000,경기도하남시신장1동,6654,3654,1.82,3445,3209,1.07
1653,4145053000,경기도하남시신장2동,46832,19765,2.37,23127,23705,0.98
1654,4145054000,경기도하남시덕풍1동,15557,7006,2.22,7912,7645,1.03
1655,4145055000,경기도하남시덕풍2동,18941,9253,2.05,9552,9389,1.02
1656,4145056000,경기도하남시덕풍3동,25378,10747,2.36,12621,12757,0.99
1657,4145057000,경기도하남시풍산동,29828,11129,2.68,14719,15109,0.97
1658,4145058000,경기도하남시감북동,2745,1526,1.8,1518,1227,1.24
1659,4145058200,경기도하남시감일동,31219,11533,2.71,15625,15594,1.0
1660,4145058500,경기도하남시위례동,27379,9783,2.8,13410,13969,0.96
1661,4145059000,경기도하남시춘궁동,3846,2156,1.78,2180,1666,1.31
1662,4145060000,경기도하남시초이동,3485,2000,1.74,1985,1500,1.32
1663,4145061000,경기도하남시미사1동,53423,27428,1.95,26631,26792,0.99
1664,4145062000,경기도하남시미사2동,47364,18598,2.55,23326,24038,0.97
1665,4146000000,경기도용인시,1077508,429492,2.51,534459,543049,0.98
1666,4146100000,경기도용인시처인구,260198,115048,2.26,133503,126695,1.05
1667,4146125000,경기도용인시처인구포곡읍,33495,14592,2.3,17300,16195,1.07
1668,4146125300,경기도용인시처인구모현읍,27119,12407,2.19,14224,12895,1.1
1669,4146125600,경기도용인시처인구이동읍,20446,9057,2.26,10468,9978,1.05
1670,4146125900,경기도용인시처인구남사읍,23904,9873,2.42,12065,11839,1.02
1671,4146134000,경기도용인시처인구원삼면,8278,4068,2.03,4305,3973,1.08
1672,4146135000,경기도용인시처인구백암면,8394,4500,1.87,4555,3839,1.19
1673,4146136000,경기도용인시처인구양지면,19493,9257,2.11,10363,9130,1.14
1674,4146151000,경기도용인시처인구중앙동,25010,12250,2.04,12718,12292,1.03
1675,4146152500,경기도용인시처인구역북동,31872,13834,2.3,16097,15775,1.02
1676,4146152600,경기도용인시처인구삼가동,12637,4840,2.61,6201,6436,0.96
1677,4146153000,경기도용인시처인구유림동,36320,14339,2.53,18337,17983,1.02
1678,4146154000,경기도용인시처인구동부동,13230,6031,2.19,6870,6360,1.08
1679,4146300000,경기도용인시기흥구,441742,173844,2.54,217999,223743,0.97
1680,4146351000,경기도용인시기흥구신갈동,38287,16134,2.37,19122,19165,1.0
1681,4146351600,경기도용인시기흥구영덕1동,30389,11721,2.59,15116,15273,0.99
1682,4146351700,경기도용인시기흥구영덕2동,17504,7214,2.43,8645,8859,0.98
1683,4146352000,경기도용인시기흥구구갈동,41715,18097,2.31,20866,20849,1.0
1684,4146353000,경기도용인시기흥구상갈동,13188,6165,2.14,6821,6367,1.07
1685,4146353500,경기도용인시기흥구보라동,33285,12434,2.68,16450,16835,0.98
1686,4146354000,경기도용인시기흥구기흥동,21625,8953,2.42,10718,10907,0.98
1687,4146355000,경기도용인시기흥구서농동,26296,11960,2.2,13548,12748,1.06
1688,4146356000,경기도용인시기흥구구성동,40258,15483,2.6,19418,20840,0.93
1689,4146357000,경기도용인시기흥구마북동,32008,12323,2.6,15647,16361,0.96
1690,4146357200,경기도용인시기흥구동백1동,32702,11633,2.81,15694,17008,0.92
1691,4146357500,경기도용인시기흥구동백2동,27264,9350,2.92,13387,13877,0.96
1692,4146357700,경기도용인시기흥구동백3동,26473,9815,2.7,12868,13605,0.95
1693,4146358600,경기도용인시기흥구상하동,24535,9215,2.66,11937,12598,0.95
1694,4146359000,경기도용인시기흥구보정동,36213,13347,2.71,17762,18451,0.96
1695,4146500000,경기도용인시수지구,375568,140600,2.67,182957,192611,0.95
1696,4146551000,경기도용인시수지구풍덕천1동,36189,15833,2.29,18038,18151,0.99
1697,4146552000,경기도용인시수지구풍덕천2동,41003,14951,2.74,20175,20828,0.97
1698,4146553000,경기도용인시수지구신봉동,37827,13407,2.82,18310,19517,0.94
1699,4146554000,경기도용인시수지구죽전1동,29168,10732,2.72,14105,15063,0.94
1700,4146555000,경기도용인시수지구죽전2동,18387,7703,2.39,9107,9280,0.98
1701,4146555500,경기도용인시수지구죽전3동,27063,10656,2.54,13007,14056,0.93
1702,4146556000,경기도용인시수지구동천동,49723,19117,2.6,24478,25245,0.97
1703,4146557000,경기도용인시수지구상현1동,20422,6754,3.02,9775,10647,0.92
1704,4146558000,경기도용인시수지구상현2동,33287,11528,2.89,16158,17129,0.94
1705,4146558500,경기도용인시수지구상현3동,27895,11114,2.51,13488,14407,0.94
1706,4146559000,경기도용인시수지구성복동,54604,18805,2.9,26316,28288,0.93
1707,4148000000,경기도파주시,483245,211916,2.28,245085,238160,1.03
1708,4148025000,경기도파주시문산읍,48437,21923,2.21,24852,23585,1.05
1709,4148025300,경기도파주시파주읍,13718,7479,1.83,7290,6428,1.13
1710,4148025600,경기도파주시법원읍,10443,5621,1.86,5585,4858,1.15
1711,4148026200,경기도파주시조리읍,29746,13014,2.29,15126,14620,1.03
1712,4148031000,경기도파주시월롱면,9438,7138,1.32,6324,3114,2.03
1713,4148032000,경기도파주시탄현면,13450,7327,1.84,7288,6162,1.18
1714,4148035000,경기도파주시광탄면,11230,6032,1.86,6143,5087,1.21
1715,4148036000,경기도파주시파평면,3872,2125,1.82,2060,1812,1.14
1716,4148037000,경기도파주시적성면,7425,3734,1.99,4044,3381,1.2
1717,4148039000,경기도파주시장단면,733,302,2.43,380,353,1.08
1718,4148051000,경기도파주시금촌1동,22193,12466,1.78,11873,10320,1.15
1719,4148052000,경기도파주시금촌2동,32786,13187,2.49,15988,16798,0.95
1720,4148053000,경기도파주시금촌3동,27632,11585,2.39,14155,13477,1.05
1721,4148054000,경기도파주시교하동,51269,20678,2.48,25882,25387,1.02
1722,4148055000,경기도파주시운정1동,51756,21029,2.46,25361,26395,0.96
1723,4148056000,경기도파주시운정2동,62676,23886,2.62,30556,32120,0.95
1724,4148057000,경기도파주시운정3동,86441,34390,2.51,42178,44263,0.95
1725,4150000000,경기도이천시,223177,101417,2.2,115727,107450,1.08
1726,4150025000,경기도이천시장호원읍,14559,6653,2.19,7412,7147,1.04
1727,4150025300,경기도이천시부발읍,36103,15710,2.3,19065,17038,1.12
1728,4150031000,경기도이천시신둔면,13923,6497,2.14,7273,6650,1.09
1729,4150032000,경기도이천시백사면,11408,5056,2.26,5808,5600,1.04
1730,4150033000,경기도이천시호법면,5944,3068,1.94,3184,2760,1.15
1731,4150034000,경기도이천시마장면,15331,7784,1.97,8404,6927,1.21
1732,4150035000,경기도이천시대월면,14602,7735,1.89,7447,7155,1.04
1733,4150036000,경기도이천시모가면,4379,2307,1.9,2340,2039,1.15
1734,4150037000,경기도이천시설성면,4713,2529,1.86,2497,2216,1.13
1735,4150038000,경기도이천시율면,2657,1463,1.82,1372,1285,1.07
1736,4150051000,경기도이천시창전동,16939,8571,1.98,8468,8471,1.0
1737,4150051500,경기도이천시증포동,57336,20680,2.77,28586,28750,0.99
1738,4150052000,경기도이천시중리동,15066,8385,1.8,8638,6428,1.34
1739,4150053000,경기도이천시관고동,10217,4979,2.05,5233,4984,1.05
1740,4155000000,경기도안성시,189534,89118,2.13,97895,91639,1.07
1741,4155025000,경기도안성시공도읍,60103,25744,2.33,30349,29754,1.02
1742,4155031000,경기도안성시보개면,5327,2663,2.0,2828,2499,1.13
1743,4155032000,경기도안성시금광면,7301,3584,2.04,3642,3659,1.0
1744,4155033000,경기도안성시서운면,3299,1684,1.96,1744,1555,1.12
1745,4155034000,경기도안성시미양면,5854,3033,1.93,3202,2652,1.21
1746,4155035000,경기도안성시대덕면,15403,8347,1.85,8671,6732,1.29
1747,4155036000,경기도안성시양성면,5245,2717,1.93,2743,2502,1.1
1748,4155038000,경기도안성시원곡면,6531,3502,1.86,3667,2864,1.28
1749,4155039000,경기도안성시일죽면,7479,3935,1.9,3911,3568,1.1
1750,4155040000,경기도안성시죽산면,6915,3790,1.82,3692,3223,1.15
1751,4155041000,경기도안성시삼죽면,3591,2033,1.77,1857,1734,1.07
1752,4155042000,경기도안성시고삼면,1932,1041,1.86,1007,925,1.09
1753,4155051000,경기도안성시안성1동,12311,5783,2.13,6167,6144,1.0
1754,4155052000,경기도안성시안성2동,25832,11936,2.16,13148,12684,1.04
1755,4155053000,경기도안성시안성3동,22411,9326,2.4,11267,11144,1.01
1756,4157000000,경기도김포시,486508,200846,2.42,243415,243093,1.0
1757,4157025000,경기도김포시통진읍,29059,14924,1.95,15531,13528,1.15
1758,4157025300,경기도김포시고촌읍,48142,18385,2.62,23991,24151,0.99
1759,4157025600,경기도김포시양촌읍,29141,14325,2.03,15356,13785,1.11
1760,4157034000,경기도김포시대곶면,9880,5631,1.75,5797,4083,1.42
1761,4157035000,경기도김포시월곶면,5440,3171,1.72,2988,2452,1.22
1762,4157036000,경기도김포시하성면,8200,4186,1.96,4463,3737,1.19
1763,4157051500,경기도김포시김포본동,60981,23137,2.64,29983,30998,0.97
1764,4157052500,경기도김포시장기본동,38875,13598,2.86,18948,19927,0.95
1765,4157054000,경기도김포시사우동,22651,9949,2.28,11360,11291,1.01
1766,4157055000,경기도김포시풍무동,61768,23614,2.62,30084,31684,0.95
1767,4157056000,경기도김포시장기동,41316,16040,2.58,20170,21146,0.95
1768,4157057000,경기도김포시구래동,45249,20028,2.26,22550,22699,0.99
1769,4157057500,경기도김포시마산동,35971,15157,2.37,17839,18132,0.98
1770,4157058000,경기도김포시운양동,49835,18701,2.66,24355,25480,0.96
1771,4159000000,경기도화성시,887015,372888,2.38,460788,426227,1.08
1772,4159025300,경기도화성시봉담읍,84747,34849,2.43,43006,41741,1.03
1773,4159025600,경기도화성시우정읍,17530,9065,1.93,9594,7936,1.21
1774,4159025900,경기도화성시향남읍,88036,40056,2.2,47273,40763,1.16
1775,4159026200,경기도화성시남양읍,43217,21048,2.05,23594,19623,1.2
1776,4159031000,경기도화성시매송면,6956,3541,1.96,3682,3274,1.12
1777,4159032000,경기도화성시비봉면,6493,3572,1.82,3684,2809,1.31
1778,4159033000,경기도화성시마도면,7016,4095,1.71,4197,2819,1.49
1779,4159034000,경기도화성시송산면,11061,5674,1.95,6006,5055,1.19
1780,4159035000,경기도화성시서신면,7262,4065,1.79,4017,3245,1.24
1781,4159036000,경기도화성시팔탄면,10083,6301,1.6,6088,3995,1.52
1782,4159037000,경기도화성시장안면,10325,5723,1.8,5984,4341,1.38
1783,4159040000,경기도화성시양감면,4027,2460,1.64,2490,1537,1.62
1784,4159041000,경기도화성시정남면,11425,6387,1.79,6629,4796,1.38
1785,4159051500,경기도화성시새솔동,24737,8273,2.99,12395,12342,1.0
1786,4159052000,경기도화성시진안동,43696,20765,2.1,23713,19983,1.19
1787,4159053000,경기도화성시병점1동,36133,15031,2.4,18611,17522,1.06
1788,4159054000,경기도화성시병점2동,23914,8792,2.72,11657,12257,0.95
1789,4159055000,경기도화성시반월동,31874,11027,2.89,16089,15785,1.02
1790,4159056000,경기도화성시기배동,13561,4944,2.74,6916,6645,1.04
1791,4159057000,경기도화성시화산동,22929,10101,2.27,12137,10792,1.12
1792,4159058500,경기도화성시동탄1동,50932,20791,2.45,26254,24678,1.06
1793,4159058600,경기도화성시동탄2동,35207,11821,2.98,17315,17892,0.97
1794,4159058700,경기도화성시동탄3동,41806,17448,2.4,21594,20212,1.07
1795,4159058800,경기도화성시동탄4동,52628,16490,3.19,26166,26462,0.99
1796,4159059000,경기도화성시동탄5동,45102,19835,2.27,22653,22449,1.01
1797,4159060000,경기도화성시동탄6동,38257,16376,2.34,19747,18510,1.07
1798,4159061000,경기도화성시동탄7동,86063,32192,2.67,43164,42899,1.01
1799,4159062000,경기도화성시동탄8동,31998,12166,2.63,16133,15865,1.02
1800,4159200000,경기도화성시동부출장소,0,0,0.0,0,0,0.0
1801,4159400000,경기도화성시동탄출장소,0,0,0.0,0,0,0.0
1802,4161000000,경기도광주시,387289,167673,2.31,197673,189616,1.04
1803,4161025000,경기도광주시오포읍,112984,49069,2.3,57022,55962,1.02
1804,4161025300,경기도광주시초월읍,46550,20133,2.31,24168,22382,1.08
1805,4161025900,경기도광주시곤지암읍,23189,11537,2.01,12365,10824,1.14
1806,4161033000,경기도광주시도척면,9558,5108,1.87,5252,4306,1.22
1807,4161034000,경기도광주시퇴촌면,15844,7500,2.11,8054,7790,1.03
1808,4161035000,경기도광주시남종면,1490,814,1.83,782,708,1.1
1809,4161037000,경기도광주시남한산성면,2493,1245,2.0,1320,1173,1.13
1810,4161051000,경기도광주시경안동,28610,13038,2.19,14725,13885,1.06
1811,4161052000,경기도광주시송정동,22041,9727,2.27,11105,10936,1.02
1812,4161054000,경기도광주시쌍령동,18308,7168,2.55,9152,9156,1.0
1813,4161055000,경기도광주시탄벌동,39051,16351,2.39,19825,19226,1.03
1814,4161056000,경기도광주시광남1동,33369,14289,2.34,17142,16227,1.06
1815,4161057000,경기도광주시광남2동,33802,11694,2.89,16761,17041,0.98
1816,4163000000,경기도양주시,236368,102314,2.31,119835,116533,1.03
1817,4163025000,경기도양주시백석읍,26330,11722,2.25,13323,13007,1.02
1818,4163031000,경기도양주시은현면,5820,3184,1.83,3310,2510,1.32
1819,4163032000,경기도양주시남면,6963,3880,1.79,3882,3081,1.26
1820,4163033000,경기도양주시광적면,11869,6029,1.97,6427,5442,1.18
1821,4163034000,경기도양주시장흥면,10883,5584,1.95,5583,5300,1.05
1822,4163051000,경기도양주시양주1동,5231,2710,1.93,2754,2477,1.11
1823,4163052000,경기도양주시양주2동,50053,19408,2.58,24510,25543,0.96
1824,4163053000,경기도양주시회천1동,9755,4763,2.05,5152,4603,1.12
1825,4163054000,경기도양주시회천2동,27285,11749,2.32,13805,13480,1.02
1826,4163055000,경기도양주시회천3동,27352,11058,2.47,13562,13790,0.98
1827,4163056000,경기도양주시회천4동,54827,22227,2.47,27527,27300,1.01
1828,4165000000,경기도포천시,148939,73584,2.02,78915,70024,1.13
1829,4165025000,경기도포천시소흘읍,45510,19803,2.3,23202,22308,1.04
1830,4165031000,경기도포천시군내면,8664,4334,2.0,4647,4017,1.16
1831,4165032000,경기도포천시내촌면,4565,2645,1.73,2647,1918,1.38
1832,4165033000,경기도포천시가산면,7586,4281,1.77,4455,3131,1.42
1833,4165034000,경기도포천시신북면,12469,6511,1.92,6878,5591,1.23
1834,4165035000,경기도포천시창수면,2115,1178,1.8,1184,931,1.27
1835,4165036000,경기도포천시영중면,4773,2677,1.78,2588,2185,1.18
1836,4165037000,경기도포천시일동면,9464,5022,1.88,4949,4515,1.1
1837,4165038000,경기도포천시이동면,6260,3416,1.83,3439,2821,1.22
1838,4165039000,경기도포천시영북면,8222,4403,1.87,4434,3788,1.17
1839,4165040000,경기도포천시관인면,2738,1513,1.81,1435,1303,1.1
1840,4165041000,경기도포천시화현면,2736,1453,1.88,1448,1288,1.12
1841,4165051000,경기도포천시포천동,18952,8812,2.15,9593,9359,1.03
1842,4165052000,경기도포천시선단동,14885,7536,1.98,8016,6869,1.17
1843,4167000000,경기도여주시,112150,52731,2.13,57022,55128,1.03
1844,4167025000,경기도여주시가남읍,15272,7537,2.03,7933,7339,1.08
1845,4167031000,경기도여주시점동면,4773,2280,2.09,2469,2304,1.07
1846,4167032000,경기도여주시흥천면,5080,2496,2.04,2672,2408,1.11
1847,4167033000,경기도여주시금사면,2954,1616,1.83,1527,1427,1.07
1848,4167034500,경기도여주시세종대왕면,6274,3107,2.02,3234,3040,1.06
1849,4167035000,경기도여주시대신면,6964,3682,1.89,3628,3336,1.09
1850,4167036000,경기도여주시북내면,4907,2440,2.01,2560,2347,1.09
1851,4167037000,경기도여주시강천면,4289,2293,1.87,2215,2074,1.07
1852,4167038000,경기도여주시산북면,2536,1257,2.02,1265,1271,1.0
1853,4167051000,경기도여주시여흥동,21775,10169,2.14,10882,10893,1.0
1854,4167052000,경기도여주시중앙동,18626,7984,2.33,9342,9284,1.01
1855,4167053000,경기도여주시오학동,18700,7870,2.38,9295,9405,0.99
1856,4180000000,경기도연천군,42721,22002,1.94,22399,20322,1.1
1857,4180025000,경기도연천군연천읍,7670,4028,1.9,4154,3516,1.18
1858,4180025300,경기도연천군전곡읍,19124,8916,2.14,9747,9377,1.04
1859,4180031000,경기도연천군군남면,3116,1707,1.83,1657,1459,1.14
1860,4180032000,경기도연천군청산면,3895,2333,1.67,2086,1809,1.15
1861,4180033000,경기도연천군백학면,2567,1374,1.87,1370,1197,1.14
1862,4180034000,경기도연천군미산면,1741,977,1.78,932,809,1.15
1863,4180035000,경기도연천군왕징면,1003,566,1.77,543,460,1.18
1864,4180036000,경기도연천군신서면,2696,1626,1.66,1427,1269,1.12
1865,4180037000,경기도연천군중면,191,112,1.71,116,75,1.55
1866,4180038000,경기도연천군장남면,718,363,1.98,367,351,1.05
1867,4182000000,경기도가평군,62264,31775,1.96,32129,30135,1.07
1868,4182025000,경기도가평군가평읍,19478,9393,2.07,9927,9551,1.04
1869,4182031000,경기도가평군설악면,9663,5194,1.86,4964,4699,1.06
1870,4182032500,경기도가평군청평면,13956,7319,1.91,7127,6829,1.04
1871,4182033000,경기도가평군상면,5626,3218,1.75,2977,2649,1.12
1872,4182034500,경기도가평군조종면,9672,4405,2.2,5145,4527,1.14
1873,4182035000,경기도가평군북면,3869,2246,1.72,1989,1880,1.06
1874,4183000000,경기도양평군,121230,59094,2.05,60846,60384,1.01
1875,4183025000,경기도양평군양평읍,30966,13938,2.22,15525,15441,1.01
1876,4183031000,경기도양평군강상면,10510,4771,2.2,5226,5284,0.99
1877,4183032000,경기도양평군강하면,4865,2654,1.83,2450,2415,1.01
1878,4183033000,경기도양평군양서면,13935,6716,2.07,6923,7012,0.99
1879,4183034000,경기도양평군옥천면,8301,4243,1.96,4222,4079,1.04
1880,4183035000,경기도양평군서종면,9982,5107,1.95,4954,5028,0.99
1881,4183036000,경기도양평군단월면,3895,2090,1.86,1989,1906,1.04
1882,4183037000,경기도양평군청운면,3802,2129,1.79,1953,1849,1.06
1883,4183038000,경기도양평군양동면,4675,2425,1.93,2348,2327,1.01
1884,4183039500,경기도양평군지평면,7038,3774,1.86,3570,3468,1.03
1885,4183040000,경기도양평군용문면,18021,8556,2.11,9037,8984,1.01
1886,4183041000,경기도양평군개군면,5240,2691,1.95,2649,2591,1.02
1887,4200000000,강원도,1538492,746220,2.06,774332,764160,1.01
1888,4211000000,강원도춘천시,284594,130277,2.18,140584,144010,0.98
1889,4211025000,강원도춘천시신북읍,7562,3655,2.07,3787,3775,1.0
1890,4211031000,강원도춘천시동면,19655,7992,2.46,9723,9932,0.98
1891,4211032000,강원도춘천시동산면,1449,794,1.82,783,666,1.18
1892,4211033000,강원도춘천시신동면,2602,1203,2.16,1351,1251,1.08
1893,4211034000,강원도춘천시남면,1073,658,1.63,580,493,1.18
1894,4211035000,강원도춘천시서면,3782,1977,1.91,1942,1840,1.06
1895,4211036000,강원도춘천시사북면,2496,1454,1.72,1238,1258,0.98
1896,4211038000,강원도춘천시북산면,967,624,1.55,529,438,1.21
1897,4211039000,강원도춘천시동내면,17202,7777,2.21,8586,8616,1.0
1898,4211040000,강원도춘천시남산면,3428,1999,1.71,1812,1616,1.12
1899,4211052000,강원도춘천시교동,3543,2285,1.55,1825,1718,1.06
1900,4211053000,강원도춘천시조운동,2700,1615,1.67,1308,1392,0.94
1901,4211054500,강원도춘천시약사명동,3339,1622,2.06,1582,1757,0.9
1902,4211057000,강원도춘천시근화동,8516,4099,2.08,4303,4213,1.02
1903,4211058000,강원도춘천시소양동,9308,4207,2.21,4571,4737,0.96
1904,4211060000,강원도춘천시후평1동,11550,6207,1.86,5762,5788,1.0
1905,4211061000,강원도춘천시후평2동,14595,6372,2.29,6944,7651,0.91
1906,4211061100,강원도춘천시후평3동,20829,9081,2.29,9921,10908,0.91
1907,4211062000,강원도춘천시효자1동,4413,1963,2.25,2206,2207,1.0
1908,4211063000,강원도춘천시효자2동,12008,7632,1.57,6349,5659,1.12
1909,4211064000,강원도춘천시효자3동,4362,2662,1.64,2223,2139,1.04
1910,4211065000,강원도춘천시석사동,34593,15004,2.31,16986,17607,0.96
1911,4211066000,강원도춘천시퇴계동,48812,19869,2.46,23540,25272,0.93
1912,4211067500,강원도춘천시강남동,22607,9728,2.32,11047,11560,0.96
1913,4211070500,강원도춘천시신사우동,23203,9798,2.37,11686,11517,1.01
1914,4213000000,강원도원주시,357757,164895,2.17,177396,180361,0.98
1915,4213025000,강원도원주시문막읍,17887,8851,2.02,9149,8738,1.05
1916,4213031000,강원도원주시소초면,8439,4405,1.92,4471,3968,1.13
1917,4213032000,강원도원주시호저면,3643,1904,1.91,1920,1723,1.11
1918,4213033000,강원도원주시지정면,29029,11693,2.48,14255,14774,0.96
1919,4213035000,강원도원주시부론면,2226,1277,1.74,1134,1092,1.04
1920,4213036000,강원도원주시귀래면,2163,1208,1.79,1114,1049,1.06
1921,4213037000,강원도원주시흥업면,9256,5098,1.82,4873,4383,1.11
1922,4213038000,강원도원주시판부면,7385,3791,1.95,3888,3497,1.11
1923,4213039000,강원도원주시신림면,3574,2000,1.79,1827,1747,1.05
1924,4213051500,강원도원주시중앙동,2577,1668,1.54,1378,1199,1.15
1925,4213052000,강원도원주시원인동,4562,2446,1.87,2176,2386,0.91
1926,4213053000,강원도원주시개운동,12740,5777,2.21,6093,6647,0.92
1927,4213054100,강원도원주시명륜1동,8398,3745,2.24,4039,4359,0.93
1928,4213054200,강원도원주시명륜2동,15519,7595,2.04,7504,8015,0.94
1929,4213055000,강원도원주시단구동,44736,19820,2.26,21951,22785,0.96
1930,4213056000,강원도원주시일산동,8576,4520,1.9,4134,4442,0.93
1931,4213057500,강원도원주시학성동,4693,2475,1.9,2334,2359,0.99
1932,4213059000,강원도원주시단계동,28820,13184,2.19,14044,14776,0.95
1933,4213060000,강원도원주시우산동,13573,6532,2.08,7172,6401,1.12
1934,4213061000,강원도원주시태장1동,10306,4800,2.15,5156,5150,1.0
1935,4213062000,강원도원주시태장2동,24745,11335,2.18,12363,12382,1.0
1936,4213063500,강원도원주시봉산동,7941,3832,2.07,3927,4014,0.98
1937,4213065000,강원도원주시행구동,7835,3179,2.46,3887,3948,0.98
1938,4213066000,강원도원주시무실동,34415,14926,2.31,16870,17545,0.96
1939,4213067500,강원도원주시반곡관설동,44719,18834,2.37,21737,22982,0.95
1940,4215000000,강원도강릉시,212965,102879,2.07,105667,107298,0.98
1941,4215025000,강원도강릉시주문진읍,16627,9243,1.8,8122,8505,0.95
1942,4215031000,강원도강릉시성산면,3449,1722,2.0,1748,1701,1.03
1943,4215032000,강원도강릉시왕산면,1574,911,1.73,843,731,1.15
1944,4215033000,강원도강릉시구정면,4225,2035,2.08,2153,2072,1.04
1945,4215034000,강원도강릉시강동면,4223,2266,1.86,2246,1977,1.14
1946,4215035000,강원도강릉시옥계면,3495,1935,1.81,1798,1697,1.06
1947,4215036000,강원도강릉시사천면,4652,2417,1.92,2412,2240,1.08
1948,4215037000,강원도강릉시연곡면,6355,3282,1.94,3181,3174,1.0
1949,4215051000,강원도강릉시홍제동,15169,7089,2.14,7387,7782,0.95
1950,4215052000,강원도강릉시중앙동,4792,2814,1.7,2299,2493,0.92
1951,4215054000,강원도강릉시옥천동,3366,2023,1.66,1735,1631,1.06
1952,4215055000,강원도강릉시교1동,25882,11714,2.21,12620,13262,0.95
1953,4215056000,강원도강릉시교2동,7746,3860,2.01,3841,3905,0.98
1954,4215057100,강원도강릉시포남1동,10448,5411,1.93,5149,5299,0.97
1955,4215057200,강원도강릉시포남2동,12792,6557,1.95,6283,6509,0.97
1956,4215058000,강원도강릉시초당동,4743,2379,1.99,2323,2420,0.96
1957,4215059000,강원도강릉시송정동,10075,4174,2.41,4827,5248,0.92
1958,4215060000,강원도강릉시내곡동,16364,7666,2.13,8177,8187,1.0
1959,4215061500,강원도강릉시강남동,17718,8314,2.13,8897,8821,1.01
1960,4215064500,강원도강릉시성덕동,28067,11957,2.35,13900,14167,0.98
1961,4215066500,강원도강릉시경포동,11203,5110,2.19,5726,5477,1.05
1962,4217000000,강원도동해시,90081,42916,2.1,45795,44286,1.03
1963,4217051000,강원도동해시천곡동,30710,13830,2.22,15291,15419,0.99
1964,4217052000,강원도동해시송정동,3754,2179,1.72,2050,1704,1.2
1965,4217053000,강원도동해시북삼동,20007,8731,2.29,10386,9621,1.08
1966,4217054000,강원도동해시부곡동,4951,2586,1.91,2403,2548,0.94
1967,4217055000,강원도동해시동호동,5118,2612,1.96,2586,2532,1.02
1968,4217057000,강원도동해시발한동,3344,1988,1.68,1702,1642,1.04
1969,4217059000,강원도동해시묵호동,3086,1824,1.69,1538,1548,0.99
1970,4217060000,강원도동해시북평동,12817,5763,2.22,6607,6210,1.06
1971,4217063000,강원도동해시망상동,3491,1859,1.88,1764,1727,1.02
1972,4217065000,강원도동해시삼화동,2803,1544,1.82,1468,1335,1.1
1973,4219000000,강원도태백시,40844,20731,1.97,20656,20188,1.02
1974,4219051500,강원도태백시황지동,6128,2929,2.09,3031,3097,0.98
1975,4219052500,강원도태백시황연동,4262,2362,1.8,2161,2101,1.03
1976,4219053500,강원도태백시삼수동,5725,2916,1.96,2946,2779,1.06
1977,4219054000,강원도태백시상장동,13106,6004,2.18,6626,6480,1.02
1978,4219058500,강원도태백시문곡소도동,3810,2047,1.86,1914,1896,1.01
1979,4219059500,강원도태백시장성동,3334,1757,1.9,1647,1687,0.98
1980,4219060500,강원도태백시구문소동,2497,1482,1.68,1300,1197,1.09
1981,4219061500,강원도태백시철암동,1982,1234,1.61,1031,951,1.08
1982,4221000000,강원도속초시,82791,40706,2.03,41080,41711,0.98
1983,4221051000,강원도속초시영랑동,4427,2481,1.78,2303,2124,1.08
1984,4221052000,강원도속초시동명동,3592,1900,1.89,1805,1787,1.01
1985,4221054000,강원도속초시금호동,6024,3199,1.88,2945,3079,0.96
1986,4221056000,강원도속초시교동,9564,4916,1.95,4687,4877,0.96
1987,4221057000,강원도속초시노학동,21873,10614,2.06,10928,10945,1.0
1988,4221058000,강원도속초시조양동,29264,13108,2.23,14306,14958,0.96
1989,4221059000,강원도속초시청호동,4932,2712,1.82,2497,2435,1.03
1990,4221060000,강원도속초시대포동,3115,1776,1.75,1609,1506,1.07
1991,4223000000,강원도삼척시,63429,33184,1.91,32043,31386,1.02
1992,4223025000,강원도삼척시도계읍,9538,5773,1.65,4719,4819,0.98
1993,4223025300,강원도삼척시원덕읍,3217,2066,1.56,1692,1525,1.11
1994,4223025400,강원도삼척시원덕읍임원출장소,1687,999,1.69,840,847,0.99
1995,4223031000,강원도삼척시근덕면,5063,3095,1.64,2612,2451,1.07
1996,4223032000,강원도삼척시하장면,1296,729,1.78,701,595,1.18
1997,4223033000,강원도삼척시노곡면,714,437,1.63,389,325,1.2
1998,4223034000,강원도삼척시미로면,1807,1049,1.72,944,863,1.09
1999,4223035000,강원도삼척시가곡면,669,413,1.62,342,327,1.05
2000,4223036000,강원도삼척시신기면,665,413,1.61,359,306,1.17
2001,4223051000,강원도삼척시남양동,7478,3992,1.87,3680,3798,0.97
2002,4223053000,강원도삼척시교동,14387,6004,2.4,7306,7081,1.03
2003,4223054000,강원도삼척시정라동,8924,4435,2.01,4526,4398,1.03
2004,4223057000,강원도삼척시성내동,7984,3779,2.11,3933,4051,0.97
2005,4272000000,강원도홍천군,68365,34237,2.0,35184,33181,1.06
2006,4272025000,강원도홍천군홍천읍,34186,15633,2.19,17266,16920,1.02
2007,4272031000,강원도홍천군화촌면,4528,2568,1.76,2414,2114,1.14
2008,4272032000,강원도홍천군두촌면,2434,1340,1.82,1212,1222,0.99
2009,4272033000,강원도홍천군내촌면,2384,1353,1.76,1244,1140,1.09
2010,4272034000,강원도홍천군서석면,3719,1925,1.93,1906,1813,1.05
2011,4272035200,강원도홍천군영귀미면,4075,2130,1.91,2114,1961,1.08
2012,4272036000,강원도홍천군남면,6197,3288,1.88,3312,2885,1.15
2013,4272037000,강원도홍천군서면,3776,2250,1.68,1976,1800,1.1
2014,4272038000,강원도홍천군북방면,3922,2057,1.91,2067,1855,1.11
2015,4272039000,강원도홍천군내면,3144,1693,1.86,1673,1471,1.14
2016,4273000000,강원도횡성군,46481,23593,1.97,23859,22622,1.05
2017,4273025000,강원도횡성군횡성읍,20967,9556,2.19,10564,10403,1.02
2018,4273031000,강원도횡성군우천면,4456,2451,1.82,2340,2116,1.11
2019,4273032000,강원도횡성군안흥면,3101,1557,1.99,1588,1513,1.05
2020,4273033000,강원도횡성군둔내면,5838,3085,1.89,3037,2801,1.08
2021,4273034000,강원도횡성군갑천면,2426,1439,1.69,1259,1167,1.08
2022,4273035000,강원도횡성군청일면,2379,1387,1.72,1212,1167,1.04
2023,4273036000,강원도횡성군공근면,3473,1948,1.78,1816,1657,1.1
2024,4273037000,강원도횡성군서원면,2092,1147,1.82,1114,978,1.14
2025,4273038000,강원도횡성군강림면,1749,1023,1.71,929,820,1.13
2026,4275000000,강원도영월군,37904,21143,1.79,19626,18278,1.07
2027,4275025000,강원도영월군영월읍,20799,10798,1.93,10637,10162,1.05
2028,4275025300,강원도영월군상동읍,1025,689,1.49,531,494,1.07
2029,4275031200,강원도영월군산솔면,1426,857,1.66,759,667,1.14
2030,4275032500,강원도영월군김삿갓면,1698,1025,1.66,880,818,1.08
2031,4275033000,강원도영월군북면,2074,1246,1.66,1097,977,1.12
2032,4275034000,강원도영월군남면,2225,1353,1.64,1187,1038,1.14
2033,4275035500,강원도영월군한반도면,1212,719,1.69,678,534,1.27
2034,4275035900,강원도영월군한반도면쌍용출장소,1658,1028,1.61,897,761,1.18
2035,4275036000,강원도영월군주천면,3740,2193,1.71,1914,1826,1.05
2036,4275038000,강원도영월군무릉도원면,2047,1235,1.66,1046,1001,1.04
2037,4276000000,강원도평창군,40996,21665,1.89,21091,19905,1.06
2038,4276025000,강원도평창군평창읍,8444,4203,2.01,4302,4142,1.04
2039,4276031000,강원도평창군미탄면,1650,944,1.75,866,784,1.1
2040,4276032000,강원도평창군방림면,852,500,1.7,445,407,1.09
2041,4276032500,강원도평창군방림면계촌출장소,1684,1000,1.68,877,807,1.09
2042,4276033000,강원도평창군대화면,5177,2757,1.88,2641,2536,1.04
2043,4276034000,강원도평창군봉평면,5712,3016,1.89,3004,2708,1.11
2044,4276035000,강원도평창군용평면,3050,1628,1.87,1537,1513,1.02
2045,4276036000,강원도평창군진부면,8546,4197,2.04,4294,4252,1.01
2046,4276038000,강원도평창군대관령면,5881,3420,1.72,3125,2756,1.13
2047,4277000000,강원도정선군,35675,19713,1.81,18565,17110,1.09
2048,4277025000,강원도정선군정선읍,10460,5152,2.03,5366,5094,1.05
2049,4277025300,강원도정선군고한읍,4363,2751,1.59,2290,2073,1.1
2050,4277025600,강원도정선군사북읍,4694,2553,1.84,2444,2250,1.09
2051,4277025900,강원도정선군신동읍,1822,1006,1.81,948,874,1.08
2052,4277026000,강원도정선군신동읍함백출장소,1592,964,1.65,794,798,0.99
2053,4277032000,강원도정선군남면,3172,1835,1.73,1686,1486,1.13
2054,4277034000,강원도정선군북평면,2476,1342,1.85,1252,1224,1.02
2055,4277035000,강원도정선군임계면,3475,2016,1.72,1845,1630,1.13
2056,4277036000,강원도정선군화암면,1630,939,1.74,889,741,1.2
2057,4277037000,강원도정선군여량면,1991,1155,1.72,1051,940,1.12
2058,4278000000,강원도철원군,43340,20862,2.08,22453,20887,1.07
2059,4278025000,강원도철원군철원읍,5262,2437,2.16,2666,2596,1.03
2060,4278025300,강원도철원군김화읍,3476,1657,2.1,1858,1618,1.15
2061,4278025600,강원도철원군갈말읍,11855,5743,2.06,6326,5529,1.14
2062,4278025900,강원도철원군동송읍,14941,7088,2.11,7523,7418,1.01
2063,4278031000,강원도철원군서면,1841,1050,1.75,1019,822,1.24
2064,4278031500,강원도철원군서면와수출장소,3671,1717,2.14,1858,1813,1.02
2065,4278032000,강원도철원군근남면,2190,1111,1.97,1155,1035,1.12
2066,4278033000,강원도철원군근북면,104,59,1.76,48,56,0.86
2067,4279000000,강원도화천군,24195,12556,1.93,13138,11057,1.19
2068,4279025000,강원도화천군화천읍,8335,3976,2.1,4354,3981,1.09
2069,4279031000,강원도화천군간동면,2688,1534,1.75,1440,1248,1.15
2070,4279032000,강원도화천군하남면,2803,1375,2.04,1467,1336,1.1
2071,4279033000,강원도화천군상서면,4077,2477,1.65,2473,1604,1.54
2072,4279034000,강원도화천군사내면,6292,3194,1.97,3404,2888,1.18
2073,4280000000,강원도양구군,21748,10660,2.04,11464,10284,1.11
2074,4280025000,강원도양구군양구읍,13802,6172,2.24,7012,6790,1.03
2075,4280031500,강원도양구군국토정중앙면,3359,1877,1.79,1894,1465,1.29
2076,4280032000,강원도양구군동면,2039,1153,1.77,1132,907,1.25
2077,4280033000,강원도양구군방산면,1290,791,1.63,746,544,1.37
2078,4280034000,강원도양구군해안면,1258,667,1.89,680,578,1.18
2079,4281000000,강원도인제군,32165,16380,1.96,17461,14704,1.19
2080,4281025000,강원도인제군인제읍,10303,4730,2.18,5414,4889,1.11
2081,4281025100,강원도인제군인제읍귀둔출장소,525,269,1.95,279,246,1.13
2082,4281031000,강원도인제군남면,3761,2027,1.86,2026,1735,1.17
2083,4281032000,강원도인제군북면,8035,4137,1.94,4335,3700,1.17
2084,4281033000,강원도인제군기린면,4977,2599,1.91,2701,2276,1.19
2085,4281034000,강원도인제군서화면,2567,1464,1.75,1556,1011,1.54
2086,4281035000,강원도인제군상남면,1997,1154,1.73,1150,847,1.36
2087,4282000000,강원도고성군,27249,15064,1.81,14019,13230,1.06
2088,4282025000,강원도고성군간성읍,7110,3508,2.03,3727,3383,1.1
2089,4282025300,강원도고성군거진읍,5989,3524,1.7,2998,2991,1.0
2090,4282031000,강원도고성군현내면,2292,1360,1.69,1115,1177,0.95
2091,4282032000,강원도고성군죽왕면,3468,1995,1.74,1786,1682,1.06
2092,4282033000,강원도고성군토성면,8390,4677,1.79,4393,3997,1.1
2093,4283000000,강원도양양군,27913,14759,1.89,14251,13662,1.04
2094,4283025000,강원도양양군양양읍,12687,6242,2.03,6462,6225,1.04
2095,4283031000,강원도양양군서면,2786,1501,1.86,1432,1354,1.06
2096,4283032000,강원도양양군손양면,2306,1250,1.84,1162,1144,1.02
2097,4283033000,강원도양양군현북면,2596,1536,1.69,1340,1256,1.07
2098,4283034000,강원도양양군현남면,2967,1724,1.72,1529,1438,1.06
2099,4283035000,강원도양양군강현면,4571,2506,1.82,2326,2245,1.04
2100,4300000000,충청북도,1597427,760672,2.1,810672,786755,1.03
2101,4311000000,충청북도청주시,848482,387016,2.19,427881,420601,1.02
2102,4311100000,충청북도청주시상당구,193827,84548,2.29,96267,97560,0.99
2103,4311131000,충청북도청주시상당구낭성면,2236,1229,1.82,1172,1064,1.1
2104,4311132000,충청북도청주시상당구미원면,4898,2863,1.71,2523,2375,1.06
2105,4311133000,충청북도청주시상당구가덕면,3859,2087,1.85,1971,1888,1.04
2106,4311134000,충청북도청주시상당구남일면,6852,3231,2.12,3502,3350,1.05
2107,4311135000,충청북도청주시상당구문의면,3891,2049,1.9,2031,1860,1.09
2108,4311152500,충청북도청주시상당구중앙동,6925,3487,1.99,3380,3545,0.95
2109,4311154500,충청북도청주시상당구성안동,6834,3953,1.73,3509,3325,1.06
2110,4311162000,충청북도청주시상당구탑대성동,8591,4154,2.07,4190,4401,0.95
2111,4311167000,충청북도청주시상당구영운동,10548,5249,2.01,5243,5305,0.99
2112,4311168000,충청북도청주시상당구금천동,31021,12641,2.45,15044,15977,0.94
2113,4311169000,충청북도청주시상당구용담.명암.산성동,13402,4916,2.73,6616,6786,0.97
2114,4311172000,충청북도청주시상당구용암1동,54832,22724,2.41,27420,27412,1.0
2115,4311173000,충청북도청주시상당구용암2동,39938,15965,2.5,19666,20272,0.97
2116,4311200000,충청북도청주시서원구,192899,89194,2.16,95958,96941,0.99
2117,4311231000,충청북도청주시서원구남이면,10073,4724,2.13,5262,4811,1.09
2118,4311232000,충청북도청주시서원구현도면,3230,1849,1.75,1677,1553,1.08
2119,4311251000,충청북도청주시서원구사직1동,6515,3328,1.96,3352,3163,1.06
2120,4311252000,충청북도청주시서원구사직2동,13728,5580,2.46,6709,7019,0.96
2121,4311253000,충청북도청주시서원구사창동,14622,8458,1.73,7314,7308,1.0
2122,4311254000,충청북도청주시서원구모충동,15644,8134,1.92,7891,7753,1.02
2123,4311255000,충청북도청주시서원구산남동,26382,10624,2.48,13176,13206,1.0
2124,4311256000,충청북도청주시서원구분평동,30172,12055,2.5,14669,15503,0.95
2125,4311257000,충청북도청주시서원구수곡1동,13247,7059,1.88,6711,6536,1.03
2126,4311258000,충청북도청주시서원구수곡2동,15920,7750,2.05,7838,8082,0.97
2127,4311259000,충청북도청주시서원구성화.개신.죽림동,43366,19633,2.21,21359,22007,0.97
2128,4311300000,충청북도청주시흥덕구,267429,123699,2.16,135780,131649,1.03
2129,4311325000,충청북도청주시흥덕구오송읍,24178,12059,2.0,12030,12148,0.99
2130,4311331000,충청북도청주시흥덕구강내면,10742,5098,2.11,5514,5228,1.05
2131,4311332000,충청북도청주시흥덕구옥산면,17932,7837,2.29,9186,8746,1.05
2132,4311370000,충청북도청주시흥덕구운천.신봉동,16746,7913,2.12,8298,8448,0.98
2133,4311374100,충청북도청주시흥덕구복대1동,50588,21130,2.39,25793,24795,1.04
2134,4311374200,충청북도청주시흥덕구복대2동,15840,8968,1.77,8114,7726,1.05
2135,4311374700,충청북도청주시흥덕구가경동,55569,22142,2.51,27189,28380,0.96
2136,4311375100,충청북도청주시흥덕구봉명1동,9666,5857,1.65,5125,4541,1.13
2137,4311375600,충청북도청주시흥덕구봉명2.송정동,24028,12246,1.96,12852,11176,1.15
2138,4311376000,충청북도청주시흥덕구강서제1동,28535,14715,1.94,14462,14073,1.03
2139,4311377000,충청북도청주시흥덕구강서제2동,13605,5734,2.37,7217,6388,1.13
2140,4311400000,충청북도청주시청원구,194327,89575,2.17,99876,94451,1.06
2141,4311425000,충청북도청주시청원구내수읍,19127,8978,2.13,9838,9289,1.06
2142,4311425300,충청북도청주시청원구오창읍,70536,31355,2.25,37627,32909,1.14
2143,4311431000,충청북도청주시청원구북이면,4534,2613,1.74,2433,2101,1.16
2144,4311451000,충청북도청주시청원구우암동,12332,7316,1.69,6230,6102,1.02
2145,4311452000,충청북도청주시청원구내덕1동,8474,4340,1.95,4267,4207,1.01
2146,4311453000,충청북도청주시청원구내덕2동,13379,6446,2.08,6849,6530,1.05
2147,4311454000,충청북도청주시청원구율량.사천동,47655,21072,2.26,23621,24034,0.98
2148,4311455000,충청북도청주시청원구오근장동,18290,7455,2.45,9011,9279,0.97
2149,4313000000,충청북도충주시,209358,99651,2.1,105932,103426,1.02
2150,4313025000,충청북도충주시주덕읍,4801,2627,1.83,2468,2333,1.06
2151,4313031000,충청북도충주시살미면,2009,1096,1.83,1025,984,1.04
2152,4313032500,충청북도충주시수안보면,2921,1674,1.74,1486,1435,1.04
2153,4313033500,충청북도충주시대소원면,9029,5375,1.68,5102,3927,1.3
2154,4313035000,충청북도충주시신니면,2928,1606,1.82,1503,1425,1.05
2155,4313036000,충청북도충주시노은면,2246,1240,1.81,1144,1102,1.04
2156,4313037000,충청북도충주시앙성면,3952,2311,1.71,2036,1916,1.06
2157,4313038500,충청북도충주시중앙탑면,13567,6050,2.24,6964,6603,1.05
2158,4313039000,충청북도충주시금가면,3778,1773,2.13,2048,1730,1.18
2159,4313040000,충청북도충주시동량면,3608,1892,1.91,1827,1781,1.03
2160,4313041000,충청북도충주시산척면,2247,1210,1.86,1158,1089,1.06
2161,4313042000,충청북도충주시엄정면,3089,1638,1.89,1559,1530,1.02
2162,4313043000,충청북도충주시소태면,1948,1047,1.86,993,955,1.04
2163,4313051500,충청북도충주시성내.충인동,2657,1517,1.75,1319,1338,0.99
2164,4313053500,충청북도충주시교현.안림동,23334,10107,2.31,11625,11709,0.99
2165,4313054000,충청북도충주시교현2동,6807,3654,1.86,3464,3343,1.04
2166,4313055000,충청북도충주시용산동,15150,6259,2.42,7425,7725,0.96
2167,4313056000,충청북도충주시지현동,5137,2457,2.09,2560,2577,0.99
2168,4313057100,충청북도충주시문화동,9388,4681,2.01,4710,4678,1.01
2169,4313058000,충청북도충주시호암.직동,19987,8324,2.4,9941,10046,0.99
2170,4313060500,충청북도충주시달천동,3711,2244,1.65,2005,1706,1.18
2171,4313061000,충청북도충주시봉방동,9237,4704,1.96,4796,4441,1.08
2172,4313062500,충청북도충주시칠금.금릉동,14463,6232,2.32,7134,7329,0.97
2173,4313063000,충청북도충주시연수동,36807,17119,2.15,18237,18570,0.98
2174,4313064000,충청북도충주시목행.용탄동,6557,2814,2.33,3403,3154,1.08
2175,4315000000,충청북도제천시,131591,64540,2.04,66170,65421,1.01
2176,4315025000,충청북도제천시봉양읍,6712,3676,1.83,3425,3287,1.04
2177,4315031000,충청북도제천시금성면,1895,1065,1.78,1015,880,1.15
2178,4315032000,충청북도제천시청풍면,1268,780,1.63,651,617,1.06
2179,4315033000,충청북도제천시수산면,2016,1235,1.63,1052,964,1.09
2180,4315034000,충청북도제천시덕산면,2141,1167,1.83,1091,1050,1.04
2181,4315035000,충청북도제천시한수면,700,403,1.74,359,341,1.05
2182,4315036000,충청북도제천시백운면,3325,1891,1.76,1719,1606,1.07
2183,4315038000,충청북도제천시송학면,4627,2539,1.82,2435,2192,1.11
2184,4315051000,충청북도제천시교동,18544,7774,2.39,9139,9405,0.97
2185,4315051800,충청북도제천시의림지동,9927,4348,2.28,4910,5017,0.98
2186,4315052800,충청북도제천시중앙동,5739,3089,1.86,2853,2886,0.99
2187,4315053700,충청북도제천시남현동,4917,2572,1.91,2462,2455,1.0
2188,4315054700,충청북도제천시영서동,10146,4932,2.06,5086,5060,1.01
2189,4315056000,충청북도제천시용두동,17816,8767,2.03,8899,8917,1.0
2190,4315057700,충청북도제천시신백동,11143,5223,2.13,5576,5567,1.0
2191,4315059000,충청북도제천시청전동,15441,8003,1.93,7771,7670,1.01
2192,4315060500,충청북도제천시화산동,15234,7076,2.15,7727,7507,1.03
2193,4372000000,충청북도보은군,31878,17039,1.87,16074,15804,1.02
2194,4372025000,충청북도보은군보은읍,14757,7192,2.05,7346,7411,0.99
2195,4372031500,충청북도보은군속리산면,1865,1095,1.7,971,894,1.09
2196,4372032500,충청북도보은군장안면,1455,790,1.84,772,683,1.13
2197,4372033000,충청북도보은군마로면,2148,1223,1.76,1030,1118,0.92
2198,4372034000,충청북도보은군탄부면,1625,958,1.7,802,823,0.97
2199,4372035000,충청북도보은군삼승면,2305,1303,1.77,1176,1129,1.04
2200,4372036000,충청북도보은군수한면,1887,1043,1.81,951,936,1.02
2201,4372037000,충청북도보은군회남면,734,465,1.58,401,333,1.2
2202,4372038500,충청북도보은군회인면,1726,1028,1.68,864,862,1.0
2203,4372039000,충청북도보은군내북면,1640,982,1.67,843,797,1.06
2204,4372040000,충청북도보은군산외면,1736,960,1.81,918,818,1.12
2205,4373000000,충청북도옥천군,50093,25104,2.0,25242,24851,1.02
2206,4373025000,충청북도옥천군옥천읍,29064,13047,2.23,14541,14523,1.0
2207,4373031000,충청북도옥천군동이면,3213,1792,1.79,1647,1566,1.05
2208,4373032000,충청북도옥천군안남면,1397,803,1.74,698,699,1.0
2209,4373033000,충청북도옥천군안내면,1906,1125,1.69,975,931,1.05
2210,4373034000,충청북도옥천군청성면,2353,1454,1.62,1175,1178,1.0
2211,4373035000,충청북도옥천군청산면,2968,1764,1.68,1434,1534,0.93
2212,4373036000,충청북도옥천군이원면,4048,2292,1.77,2083,1965,1.06
2213,4373037000,충청북도옥천군군서면,2183,1264,1.73,1140,1043,1.09
2214,4373038000,충청북도옥천군군북면,2961,1563,1.89,1549,1412,1.1
2215,4374000000,충청북도영동군,45773,23813,1.92,22810,22963,0.99
2216,4374025000,충청북도영동군영동읍,20163,9450,2.13,9954,10209,0.98
2217,4374031000,충청북도영동군용산면,3228,1844,1.75,1647,1581,1.04
2218,4374032000,충청북도영동군황간면,4208,2187,1.92,2121,2087,1.02
2219,4374033500,충청북도영동군추풍령면,2227,1253,1.78,1113,1114,1.0
2220,4374034000,충청북도영동군매곡면,1893,1079,1.75,950,943,1.01
2221,4374035000,충청북도영동군상촌면,2289,1327,1.72,1117,1172,0.95
2222,4374036000,충청북도영동군양강면,3119,1634,1.91,1578,1541,1.02
2223,4374037000,충청북도영동군용화면,973,594,1.64,481,492,0.98
2224,4374038000,충청북도영동군학산면,2739,1607,1.7,1373,1366,1.01
2225,4374039000,충청북도영동군양산면,1799,1026,1.75,896,903,0.99
2226,4374040000,충청북도영동군심천면,3135,1812,1.73,1580,1555,1.02
2227,4374500000,충청북도증평군,36426,17832,2.04,18993,17433,1.09
2228,4374525000,충청북도증평군증평읍,34617,16832,2.06,18045,16572,1.09
2229,4374531000,충청북도증평군도안면,1809,1000,1.81,948,861,1.1
2230,4375000000,충청북도진천군,85176,41323,2.06,44715,40461,1.11
2231,4375025000,충청북도진천군진천읍,30157,14480,2.08,15512,14645,1.06
2232,4375025300,충청북도진천군덕산읍,29625,13124,2.26,15646,13979,1.12
2233,4375025400,충청북도진천군덕산읍혁신도시출장소,0,0,0.0,0,0,0.0
2234,4375032000,충청북도진천군초평면,3118,1684,1.85,1618,1500,1.08
2235,4375033000,충청북도진천군문백면,3469,1905,1.82,1816,1653,1.1
2236,4375034000,충청북도진천군백곡면,2082,1242,1.68,1068,1014,1.05
2237,4375035000,충청북도진천군이월면,6211,3472,1.79,3304,2907,1.14
2238,4375037000,충청북도진천군광혜원면,10514,5416,1.94,5751,4763,1.21
2239,4376000000,충청북도괴산군,38122,21851,1.74,19612,18510,1.06
2240,4376025000,충청북도괴산군괴산읍,9753,5156,1.89,4993,4760,1.05
2241,4376031000,충청북도괴산군감물면,2196,1210,1.81,1150,1046,1.1
2242,4376032000,충청북도괴산군장연면,1955,1179,1.66,994,961,1.03
2243,4376033000,충청북도괴산군연풍면,2428,1478,1.64,1252,1176,1.06
2244,4376034000,충청북도괴산군칠성면,3177,1854,1.71,1600,1577,1.01
2245,4376035000,충청북도괴산군문광면,2246,1317,1.71,1155,1091,1.06
2246,4376036000,충청북도괴산군청천면,5211,3159,1.65,2711,2500,1.08
2247,4376037000,충청북도괴산군청안면,3436,2040,1.68,1757,1679,1.05
2248,4376039000,충청북도괴산군사리면,2805,1598,1.76,1439,1366,1.05
2249,4376040000,충청북도괴산군소수면,2105,1231,1.71,1093,1012,1.08
2250,4376041000,충청북도괴산군불정면,2810,1629,1.72,1468,1342,1.09
2251,4377000000,충청북도음성군,92197,47431,1.94,48883,43314,1.13
2252,4377025000,충청북도음성군음성읍,16669,8384,1.99,8515,8154,1.04
2253,4377025300,충청북도음성군금왕읍,19566,10046,1.95,10490,9076,1.16
2254,4377031000,충청북도음성군소이면,2869,1644,1.75,1467,1402,1.05
2255,4377032000,충청북도음성군원남면,3001,1769,1.7,1560,1441,1.08
2256,4377033000,충청북도음성군맹동면,13082,6007,2.18,6929,6153,1.13
2257,4377034000,충청북도음성군대소면,15770,7913,1.99,8629,7141,1.21
2258,4377035000,충청북도음성군삼성면,6815,3876,1.76,3793,3022,1.26
2259,4377036000,충청북도음성군생극면,4511,2552,1.77,2440,2071,1.18
2260,4377037000,충청북도음성군감곡면,9914,5240,1.89,5060,4854,1.04
2261,4380000000,충청북도단양군,28331,15072,1.88,14360,13971,1.03
2262,4380025000,충청북도단양군단양읍,10329,5011,2.06,5163,5166,1.0
2263,4380025300,충청북도단양군매포읍,5223,2638,1.98,2707,2516,1.08
2264,4380031000,충청북도단양군대강면,2449,1450,1.69,1225,1224,1.0
2265,4380032000,충청북도단양군가곡면,2072,1155,1.79,1105,967,1.14
2266,4380033000,충청북도단양군영춘면,3193,1832,1.74,1531,1662,0.92
2267,4380034000,충청북도단양군어상천면,1861,1054,1.77,1023,838,1.22
2268,4380035000,충청북도단양군적성면,1525,917,1.66,781,744,1.05
2269,4380036000,충청북도단양군단성면,1679,1015,1.65,825,854,0.97
2270,4400000000,충청남도,2119257,1001915,2.12,1083366,1035891,1.05
2271,4413000000,충청남도천안시,658486,297987,2.21,336612,321874,1.05
2272,4413100000,충청남도천안시동남구,255292,116963,2.18,129399,125893,1.03
2273,4413125000,충청남도천안시동남구목천읍,24376,11362,2.15,12465,11911,1.05
2274,4413131000,충청남도천안시동남구풍세면,4068,2195,1.85,2243,1825,1.23
2275,4413132000,충청남도천안시동남구광덕면,4301,2382,1.81,2173,2128,1.02
2276,4413133000,충청남도천안시동남구북면,4349,2471,1.76,2277,2072,1.1
2277,4413134000,충청남도천안시동남구성남면,3078,1620,1.9,1606,1472,1.09
2278,4413135000,충청남도천안시동남구수신면,2254,1303,1.73,1232,1022,1.21
2279,4413136000,충청남도천안시동남구병천면,6149,3449,1.78,3282,2867,1.14
2280,4413137000,충청남도천안시동남구동면,2071,1174,1.76,1118,953,1.17
2281,4413151000,충청남도천안시동남구중앙동,5368,3153,1.7,2800,2568,1.09
2282,4413152000,충청남도천안시동남구문성동,4230,2543,1.66,2218,2012,1.1
2283,4413153000,충청남도천안시동남구원성1동,8608,4240,2.03,4449,4159,1.07
2284,4413154000,충청남도천안시동남구원성2동,9191,4858,1.89,4716,4475,1.05
2285,4413155000,충청남도천안시동남구봉명동,18018,9178,1.96,9238,8780,1.05
2286,4413156000,충청남도천안시동남구일봉동,23052,8689,2.65,11462,11590,0.99
2287,4413157000,충청남도천안시동남구신방동,44450,18571,2.39,22750,21700,1.05
2288,4413158000,충청남도천안시동남구청룡동,54874,21425,2.56,27393,27481,1.0
2289,4413159000,충청남도천안시동남구신안동,36855,18350,2.01,17977,18878,0.95
2290,4413300000,충청남도천안시서북구,403194,181024,2.23,207213,195981,1.06
2291,4413325000,충청남도천안시서북구성환읍,23797,11208,2.12,12420,11377,1.09
2292,4413325300,충청남도천안시서북구성거읍,21502,9655,2.23,11267,10235,1.1
2293,4413325600,충청남도천안시서북구직산읍,20057,9791,2.05,10926,9131,1.2
2294,4413331000,충청남도천안시서북구입장면,8420,4490,1.88,4562,3858,1.18
2295,4413351000,충청남도천안시서북구성정1동,17780,9726,1.83,9366,8414,1.11
2296,4413352000,충청남도천안시서북구성정2동,25868,17609,1.47,13987,11881,1.18
2297,4413353000,충청남도천안시서북구쌍용1동,13796,6304,2.19,6759,7037,0.96
2298,4413354000,충청남도천안시서북구쌍용2동,37323,14682,2.54,18368,18955,0.97
2299,4413355000,충청남도천안시서북구쌍용3동,18708,8116,2.31,9060,9648,0.94
2300,4413356000,충청남도천안시서북구백석동,40497,14584,2.78,20373,20124,1.01
2301,4413356600,충청남도천안시서북구불당1동,33189,13124,2.53,16637,16552,1.01
2302,4413356700,충청남도천안시서북구불당2동,37270,13533,2.75,18624,18646,1.0
2303,4413358000,충청남도천안시서북구부성1동,47267,23422,2.02,24407,22860,1.07
2304,4413359000,충청남도천안시서북구부성2동,57720,24780,2.33,30457,27263,1.12
2305,4415000000,충청남도공주시,103145,51580,2.0,51459,51686,1.0
2306,4415025000,충청남도공주시유구읍,7259,3804,1.91,3648,3611,1.01
2307,4415031000,충청남도공주시이인면,3185,1658,1.92,1622,1563,1.04
2308,4415032000,충청남도공주시탄천면,2916,1630,1.79,1505,1411,1.07
2309,4415033000,충청남도공주시계룡면,5380,3052,1.76,2756,2624,1.05
2310,4415034000,충청남도공주시반포면,4255,2187,1.95,2217,2038,1.09
2311,4415036000,충청남도공주시의당면,4628,2413,1.92,2401,2227,1.08
2312,4415037000,충청남도공주시정안면,4591,2457,1.87,2381,2210,1.08
2313,4415038000,충청남도공주시우성면,5157,2735,1.89,2671,2486,1.07
2314,4415039000,충청남도공주시사곡면,2850,1514,1.88,1424,1426,1.0
2315,4415040000,충청남도공주시신풍면,3161,1551,2.04,1409,1752,0.8
2316,4415051000,충청남도공주시중학동,4598,2537,1.81,2316,2282,1.01
2317,4415054000,충청남도공주시웅진동,8250,4047,2.04,4045,4205,0.96
2318,4415055000,충청남도공주시금학동,5353,2548,2.1,2676,2677,1.0
2319,4415056000,충청남도공주시옥룡동,7847,4193,1.87,3945,3902,1.01
2320,4415057000,충청남도공주시신관동,19425,9461,2.05,9426,9999,0.94
2321,4415059000,충청남도공주시월송동,14290,5793,2.47,7017,7273,0.96
2322,4418000000,충청남도보령시,98408,49419,1.99,49933,48475,1.03
2323,4418025000,충청남도보령시웅천읍,6018,3466,1.74,3044,2974,1.02
2324,4418031000,충청남도보령시주포면,1632,954,1.71,855,777,1.1
2325,4418032000,충청남도보령시오천면,2149,1190,1.81,1138,1011,1.13
2326,4418032500,충청남도보령시오천면어항출장소,1602,860,1.86,859,743,1.16
2327,4418032800,충청남도보령시원산도출장소,1113,589,1.89,602,511,1.18
2328,4418033000,충청남도보령시천북면,3423,1837,1.86,1773,1650,1.07
2329,4418034000,충청남도보령시청소면,2593,1470,1.76,1300,1293,1.01
2330,4418035000,충청남도보령시청라면,3851,2092,1.84,1940,1911,1.02
2331,4418036000,충청남도보령시남포면,5101,2783,1.83,2566,2535,1.01
2332,4418038000,충청남도보령시주산면,2398,1439,1.67,1194,1204,0.99
2333,4418039000,충청남도보령시미산면,1702,1013,1.68,873,829,1.05
2334,4418040000,충청남도보령시성주면,2148,1201,1.79,1073,1075,1.0
2335,4418041000,충청남도보령시주교면,5160,2515,2.05,2727,2433,1.12
2336,4418051500,충청남도보령시대천1동,14048,6687,2.1,7076,6972,1.01
2337,4418052500,충청남도보령시대천2동,6721,3230,2.08,3394,3327,1.02
2338,4418053500,충청남도보령시대천3동,16196,7345,2.21,8128,8068,1.01
2339,4418054500,충청남도보령시대천4동,16276,7267,2.24,8129,8147,1.0
2340,4418056500,충청남도보령시대천5동,6277,3481,1.8,3262,3015,1.08
2341,4420000000,충청남도아산시,324580,145869,2.23,168881,155699,1.08
2342,4420025000,충청남도아산시염치읍,6459,3196,2.02,3404,3055,1.11
2343,4420025300,충청남도아산시배방읍,81661,35128,2.32,41883,39778,1.05
2344,4420031000,충청남도아산시송악면,4194,1936,2.17,2147,2047,1.05
2345,4420033000,충청남도아산시탕정면,24910,10769,2.31,13504,11406,1.18
2346,4420035000,충청남도아산시음봉면,20408,9415,2.17,11083,9325,1.19
2347,4420036000,충청남도아산시둔포면,22608,11747,1.92,12766,9842,1.3
2348,4420037000,충청남도아산시영인면,5525,2789,1.98,2915,2610,1.12
2349,4420038000,충청남도아산시인주면,6243,3476,1.8,3484,2759,1.26
2350,4420039000,충청남도아산시선장면,3040,1631,1.86,1560,1480,1.05
2351,4420040000,충청남도아산시도고면,4439,2357,1.88,2276,2163,1.05
2352,4420041000,충청남도아산시신창면,19644,9425,2.08,10281,9363,1.1
2353,4420057000,충청남도아산시온양1동,9344,4548,2.05,4887,4457,1.1
2354,4420058000,충청남도아산시온양2동,10746,5847,1.84,5613,5133,1.09
2355,4420059000,충청남도아산시온양3동,36577,14668,2.49,18327,18250,1.0
2356,4420060000,충청남도아산시온양4동,18557,7889,2.35,9447,9110,1.04
2357,4420061000,충청남도아산시온양5동,21442,8810,2.43,11015,10427,1.06
2358,4420062000,충청남도아산시온양6동,28783,12238,2.35,14289,14494,0.99
2359,4421000000,충청남도서산시,176645,81407,2.17,92122,84523,1.09
2360,4421025000,충청남도서산시대산읍,13493,7152,1.89,7864,5629,1.4
2361,4421031000,충청남도서산시인지면,7291,3392,2.15,3715,3576,1.04
2362,4421032000,충청남도서산시부석면,5267,2814,1.87,2680,2587,1.04
2363,4421033000,충청남도서산시팔봉면,3338,1801,1.85,1701,1637,1.04
2364,4421034000,충청남도서산시지곡면,8172,3860,2.12,4392,3780,1.16
2365,4421036000,충청남도서산시성연면,15447,6215,2.49,8099,7348,1.1
2366,4421037000,충청남도서산시음암면,9281,4456,2.08,4797,4484,1.07
2367,4421038000,충청남도서산시운산면,5012,2701,1.86,2542,2470,1.03
2368,4421039000,충청남도서산시해미면,7285,3973,1.83,3760,3525,1.07
2369,4421040000,충청남도서산시고북면,6044,2912,2.08,3129,2915,1.07
2370,4421051000,충청남도서산시부춘동,19079,8922,2.14,9956,9123,1.09
2371,4421052500,충청남도서산시동문1동,18586,7751,2.4,9693,8893,1.09
2372,4421053500,충청남도서산시동문2동,8766,4422,1.98,4425,4341,1.02
2373,4421054000,충청남도서산시수석동,15852,7294,2.17,8075,7777,1.04
2374,4421055000,충청남도서산시석남동,33732,13742,2.45,17294,16438,1.05
2375,4423000000,충청남도논산시,114483,58048,1.97,57147,57336,1.0
2376,4423025000,충청남도논산시강경읍,7961,4286,1.86,3918,4043,0.97
2377,4423025300,충청남도논산시연무읍,13343,6782,1.97,6658,6685,1.0
2378,4423031000,충청남도논산시성동면,4024,2154,1.87,2026,1998,1.01
2379,4423032000,충청남도논산시광석면,4123,2232,1.85,2075,2048,1.01
2380,4423033000,충청남도논산시노성면,2940,1612,1.82,1488,1452,1.02
2381,4423034000,충청남도논산시상월면,3492,1923,1.82,1753,1739,1.01
2382,4423035000,충청남도논산시부적면,3514,1945,1.81,1786,1728,1.03
2383,4423036000,충청남도논산시연산면,6056,3389,1.79,3121,2935,1.06
2384,4423038000,충청남도논산시벌곡면,2424,1427,1.7,1230,1194,1.03
2385,4423039000,충청남도논산시양촌면,6132,3006,2.04,3112,3020,1.03
2386,4423040000,충청남도논산시가야곡면,3380,1930,1.75,1721,1659,1.04
2387,4423041000,충청남도논산시은진면,3981,2311,1.72,2115,1866,1.13
2388,4423042000,충청남도논산시채운면,2177,1171,1.86,1041,1136,0.92
2389,4423051000,충청남도논산시취암동,34943,16561,2.11,17384,17559,0.99
2390,4423052000,충청남도논산시부창동,15993,7319,2.19,7719,8274,0.93
2391,4425000000,충청남도계룡시,43331,17152,2.53,21563,21768,0.99
2392,4425031000,충청남도계룡시두마면,7879,3255,2.42,3873,4006,0.97
2393,4425031500,충청남도계룡시엄사면,18266,7812,2.34,8897,9369,0.95
2394,4425033000,충청남도계룡시신도안면,8613,2669,3.23,4494,4119,1.09
2395,4425051000,충청남도계룡시금암동,8573,3416,2.51,4299,4274,1.01
2396,4427000000,충청남도당진시,167092,79526,2.1,88952,78140,1.14
2397,4427025000,충청남도당진시합덕읍,8700,4624,1.88,4580,4120,1.11
2398,4427025300,충청남도당진시송악읍,30469,14449,2.11,16914,13555,1.25
2399,4427031000,충청남도당진시고대면,5295,2761,1.92,2716,2579,1.05
2400,4427032000,충청남도당진시석문면,9624,5837,1.65,5689,3935,1.45
2401,4427033000,충청남도당진시대호지면,2386,1255,1.9,1204,1182,1.02
2402,4427034000,충청남도당진시정미면,3593,1955,1.84,1842,1751,1.05
2403,4427035000,충청남도당진시면천면,3514,1843,1.91,1806,1708,1.06
2404,4427036000,충청남도당진시순성면,5040,2605,1.93,2540,2500,1.02
2405,4427037000,충청남도당진시우강면,5298,2623,2.02,2661,2637,1.01
2406,4427038000,충청남도당진시신평면,15391,6647,2.32,7852,7539,1.04
2407,4427039000,충청남도당진시송산면,11787,6034,1.95,6772,5015,1.35
2408,4427051000,충청남도당진시당진1동,24803,12050,2.06,13240,11563,1.15
2409,4427052000,충청남도당진시당진2동,23277,9668,2.41,11880,11397,1.04
2410,4427053000,충청남도당진시당진3동,17915,7175,2.5,9256,8659,1.07
2411,4471000000,충청남도금산군,50477,25893,1.95,25466,25011,1.02
2412,4471025000,충청남도금산군금산읍,22381,10286,2.18,10981,11400,0.96
2413,4471031000,충청남도금산군금성면,3252,1804,1.8,1687,1565,1.08
2414,4471032000,충청남도금산군제원면,2768,1590,1.74,1450,1318,1.1
2415,4471033000,충청남도금산군부리면,2468,1422,1.74,1244,1224,1.02
2416,4471034000,충청남도금산군군북면,2505,1359,1.84,1249,1256,0.99
2417,4471035000,충청남도금산군남일면,2766,1434,1.93,1397,1369,1.02
2418,4471036000,충청남도금산군남이면,2116,1165,1.82,1083,1033,1.05
2419,4471037000,충청남도금산군진산면,3244,1859,1.75,1618,1626,1.0
2420,4471038000,충청남도금산군복수면,2998,1697,1.77,1572,1426,1.1
2421,4471039000,충청남도금산군추부면,5979,3277,1.82,3185,2794,1.14
2422,4476000000,충청남도부여군,63774,33257,1.92,31634,32140,0.98
2423,4476025000,충청남도부여군부여읍,19575,9641,2.03,9730,9845,0.99
2424,4476031000,충청남도부여군규암면,11927,5760,2.07,5868,6059,0.97
2425,4476032000,충청남도부여군은산면,3676,1923,1.91,1850,1826,1.01
2426,4476033000,충청남도부여군외산면,2332,1324,1.76,1146,1186,0.97
2427,4476034000,충청남도부여군내산면,1543,839,1.84,761,782,0.97
2428,4476035000,충청남도부여군구룡면,2347,1274,1.84,1150,1197,0.96
2429,4476036000,충청남도부여군홍산면,2809,1515,1.85,1354,1455,0.93
2430,4476037000,충청남도부여군옥산면,1415,799,1.77,685,730,0.94
2431,4476038000,충청남도부여군남면,1807,1010,1.79,876,931,0.94
2432,4476039000,충청남도부여군충화면,1137,675,1.68,576,561,1.03
2433,4476040000,충청남도부여군양화면,1654,1010,1.64,779,875,0.89
2434,4476041000,충청남도부여군임천면,2850,1594,1.79,1406,1444,0.97
2435,4476042000,충청남도부여군장암면,2701,1522,1.77,1363,1338,1.02
2436,4476043000,충청남도부여군세도면,3091,1730,1.79,1571,1520,1.03
2437,4476044000,충청남도부여군석성면,2820,1466,1.92,1466,1354,1.08
2438,4476045000,충청남도부여군초촌면,2090,1175,1.78,1053,1037,1.02
2439,4477000000,충청남도서천군,50745,26646,1.9,25081,25664,0.98
2440,4477025000,충청남도서천군장항읍,11064,5801,1.91,5542,5522,1.0
2441,4477025300,충청남도서천군서천읍,13356,6090,2.19,6534,6822,0.96
2442,4477031000,충청남도서천군마서면,4808,2627,1.83,2405,2403,1.0
2443,4477032000,충청남도서천군화양면,2246,1256,1.79,1092,1154,0.95
2444,4477033000,충청남도서천군기산면,1610,932,1.73,791,819,0.97
2445,4477034000,충청남도서천군한산면,2458,1410,1.74,1154,1304,0.88
2446,4477035000,충청남도서천군마산면,1462,811,1.8,698,764,0.91
2447,4477036000,충청남도서천군시초면,1243,709,1.75,597,646,0.92
2448,4477037000,충청남도서천군문산면,1232,726,1.7,627,605,1.04
2449,4477038000,충청남도서천군판교면,2080,1194,1.74,1009,1071,0.94
2450,4477039000,충청남도서천군종천면,2025,1172,1.73,979,1046,0.94
2451,4477040000,충청남도서천군비인면,2865,1612,1.78,1421,1444,0.98
2452,4477041000,충청남도서천군서면,4296,2306,1.86,2232,2064,1.08
2453,4479000000,충청남도청양군,30440,16426,1.85,15472,14968,1.03
2454,4479025000,충청남도청양군청양읍,9914,5092,1.95,5010,4904,1.02
2455,4479031000,충청남도청양군운곡면,2104,1219,1.73,1058,1046,1.01
2456,4479032000,충청남도청양군대치면,2215,1227,1.81,1156,1059,1.09
2457,4479033000,충청남도청양군정산면,3560,1946,1.83,1862,1698,1.1
2458,4479034000,충청남도청양군목면,1504,813,1.85,789,715,1.1
2459,4479035000,충청남도청양군청남면,1895,1021,1.86,981,914,1.07
2460,4479036000,충청남도청양군장평면,2277,1216,1.87,1159,1118,1.04
2461,4479037000,충청남도청양군남양면,2713,1522,1.78,1348,1365,0.99
2462,4479038000,충청남도청양군화성면,2178,1198,1.82,1092,1086,1.01
2463,4479039000,충청남도청양군비봉면,2080,1172,1.77,1017,1063,0.96
2464,4480000000,충청남도홍성군,99324,46746,2.12,49437,49887,0.99
2465,4480025000,충청남도홍성군홍성읍,37645,17885,2.1,18624,19021,0.98
2466,4480025300,충청남도홍성군광천읍,8292,4373,1.9,4104,4188,0.98
2467,4480025600,충청남도홍성군홍북읍,29123,11397,2.56,14603,14520,1.01
2468,4480032000,충청남도홍성군금마면,3502,1879,1.86,1791,1711,1.05
2469,4480033000,충청남도홍성군홍동면,3411,1706,2.0,1710,1701,1.01
2470,4480034000,충청남도홍성군장곡면,2837,1568,1.81,1356,1481,0.92
2471,4480035000,충청남도홍성군은하면,2237,1225,1.83,1129,1108,1.02
2472,4480036000,충청남도홍성군결성면,2056,1163,1.77,1007,1049,0.96
2473,4480037000,충청남도홍성군서부면,3205,1682,1.91,1570,1635,0.96
2474,4480038000,충청남도홍성군갈산면,3521,1951,1.8,1771,1750,1.01
2475,4480039000,충청남도홍성군구항면,3495,1917,1.82,1772,1723,1.03
2476,4481000000,충청남도예산군,76801,39051,1.97,38574,38227,1.01
2477,4481025000,충청남도예산군예산읍,32682,15497,2.11,16217,16465,0.98
2478,4481025300,충청남도예산군삽교읍,10155,5253,1.93,5096,5059,1.01
2479,4481031000,충청남도예산군대술면,2387,1342,1.78,1222,1165,1.05
2480,4481032000,충청남도예산군신양면,2998,1622,1.85,1516,1482,1.02
2481,4481033000,충청남도예산군광시면,3105,1695,1.83,1533,1572,0.98
2482,4481034000,충청남도예산군대흥면,1756,986,1.78,891,865,1.03
2483,4481035000,충청남도예산군응봉면,2504,1350,1.85,1309,1195,1.1
2484,4481036000,충청남도예산군덕산면,6675,3470,1.92,3326,3349,0.99
2485,4481037000,충청남도예산군봉산면,2490,1329,1.87,1263,1227,1.03
2486,4481038000,충청남도예산군고덕면,4407,2328,1.89,2236,2171,1.03
2487,4481039000,충청남도예산군신암면,3404,1891,1.8,1743,1661,1.05
2488,4481040000,충청남도예산군오가면,4238,2288,1.85,2222,2016,1.1
2489,4482500000,충청남도태안군,61526,32908,1.87,31033,30493,1.02
2490,4482525000,충청남도태안군태안읍,29393,14294,2.06,14857,14536,1.02
2491,4482525300,충청남도태안군안면읍,8417,4792,1.76,4177,4240,0.99
2492,4482531000,충청남도태안군고남면,2330,1343,1.73,1118,1212,0.92
2493,4482532000,충청남도태안군남면,4197,2421,1.73,2161,2036,1.06
2494,4482533000,충청남도태안군근흥면,5347,3125,1.71,2742,2605,1.05
2495,4482534000,충청남도태안군소원면,5300,3111,1.7,2623,2677,0.98
2496,4482535000,충청남도태안군원북면,4348,2558,1.7,2228,2120,1.05
2497,4482536000,충청남도태안군이원면,2194,1264,1.74,1127,1067,1.06
2498,4500000000,전라북도,1786855,849001,2.1,888994,897861,0.99
2499,4511000000,전라북도전주시,657269,293207,2.24,323427,333842,0.97
2500,4511100000,전라북도전주시완산구,335804,152056,2.21,163494,172310,0.95
2501,4511151000,전라북도전주시완산구중앙동,7398,3888,1.9,3707,3691,1.0
2502,4511153000,전라북도전주시완산구풍남동,4023,2424,1.66,1996,2027,0.98
2503,4511160500,전라북도전주시완산구노송동,11917,6196,1.92,5825,6092,0.96
2504,4511163500,전라북도전주시완산구완산동,5414,2818,1.92,2663,2751,0.97
2505,4511165000,전라북도전주시완산구동서학동,6269,3188,1.97,3105,3164,0.98
2506,4511166000,전라북도전주시완산구서서학동,8619,4483,1.92,4222,4397,0.96
2507,4511167100,전라북도전주시완산구중화산1동,14335,6395,2.24,6896,7439,0.93
2508,4511167200,전라북도전주시완산구중화산2동,19688,9129,2.16,9833,9855,1.0
2509,4511168000,전라북도전주시완산구서신동,40880,17418,2.35,19831,21049,0.94
2510,4511169100,전라북도전주시완산구평화1동,12874,7231,1.78,6199,6675,0.93
2511,4511169200,전라북도전주시완산구평화2동,45827,18806,2.44,22089,23738,0.93
2512,4511170100,전라북도전주시완산구삼천1동,11502,5086,2.26,5599,5903,0.95
2513,4511170200,전라북도전주시완산구삼천2동,13436,6236,2.15,6465,6971,0.93
2514,4511170300,전라북도전주시완산구삼천3동,21952,9128,2.4,10619,11333,0.94
2515,4511171100,전라북도전주시완산구효자1동,10731,4880,2.2,5141,5590,0.92
2516,4511171200,전라북도전주시완산구효자2동,10040,4622,2.17,4786,5254,0.91
2517,4511171300,전라북도전주시완산구효자3동,14686,6001,2.45,6909,7777,0.89
2518,4511171400,전라북도전주시완산구효자4동,39426,16332,2.41,19174,20252,0.95
2519,4511173000,전라북도전주시완산구효자5동,36787,17795,2.07,18435,18352,1.0
2520,4511300000,전라북도전주시덕진구,321465,141151,2.28,159933,161532,0.99
2521,4511352500,전라북도전주시덕진구진북동,14084,6931,2.03,6875,7209,0.95
2522,4511354000,전라북도전주시덕진구인후1동,18232,7560,2.41,8748,9484,0.92
2523,4511355000,전라북도전주시덕진구인후2동,11097,5905,1.88,5536,5561,1.0
2524,4511356000,전라북도전주시덕진구인후3동,31930,14633,2.18,15676,16254,0.96
2525,4511357000,전라북도전주시덕진구덕진동,20831,10473,1.99,10564,10267,1.03
2526,4511358000,전라북도전주시덕진구금암1동,7809,5314,1.47,4222,3587,1.18
2527,4511359000,전라북도전주시덕진구금암2동,9782,5078,1.93,4825,4957,0.97
2528,4511360000,전라북도전주시덕진구팔복동,7519,4259,1.77,4109,3410,1.2
2529,4511361100,전라북도전주시덕진구우아1동,12462,5984,2.08,6219,6243,1.0
2530,4511361200,전라북도전주시덕진구우아2동,14481,7623,1.9,7564,6917,1.09
2531,4511362000,전라북도전주시덕진구호성동,19907,7959,2.5,9544,10363,0.92
2532,4511364100,전라북도전주시덕진구송천1동,63781,23406,2.72,31610,32171,0.98
2533,4511364200,전라북도전주시덕진구송천2동,26102,10420,2.5,12733,13369,0.95
2534,4511365000,전라북도전주시덕진구조촌동,12573,6336,1.98,6469,6104,1.06
2535,4511366500,전라북도전주시덕진구여의동,30638,12469,2.46,15414,15224,1.01
2536,4511367000,전라북도전주시덕진구혁신동,20237,6801,2.98,9825,10412,0.94
2537,4511800000,전라북도전주시효자출장소,0,0,0.0,0,0,0.0
2538,4513000000,전라북도군산시,265304,122250,2.17,134290,131014,1.03
2539,4513025000,전라북도군산시옥구읍,3103,1672,1.86,1599,1504,1.06
2540,4513031000,전라북도군산시옥산면,4695,2003,2.34,2390,2305,1.04
2541,4513032000,전라북도군산시회현면,3356,1549,2.17,1722,1634,1.05
2542,4513033000,전라북도군산시임피면,2623,1443,1.82,1344,1279,1.05
2543,4513034000,전라북도군산시서수면,2503,1325,1.89,1260,1243,1.01
2544,4513035000,전라북도군산시대야면,4864,2633,1.85,2422,2442,0.99
2545,4513036000,전라북도군산시개정면,2940,1491,1.97,1497,1443,1.04
2546,4513037000,전라북도군산시성산면,2854,1414,2.02,1425,1429,1.0
2547,4513038000,전라북도군산시나포면,2166,1153,1.88,1134,1032,1.1
2548,4513039000,전라북도군산시옥도면,3285,1824,1.8,1848,1437,1.29
2549,4513040000,전라북도군산시옥서면,2923,1553,1.88,1491,1432,1.04
2550,4513051500,전라북도군산시해신동,2260,1229,1.84,1103,1157,0.95
2551,4513053000,전라북도군산시월명동,5190,2844,1.82,2591,2599,1.0
2552,4513055000,전라북도군산시신풍동,6965,3414,2.04,3467,3498,0.99
2553,4513056000,전라북도군산시삼학동,5439,2888,1.88,2642,2797,0.94
2554,4513060500,전라북도군산시중앙동,4358,2441,1.79,2215,2143,1.03
2555,4513064000,전라북도군산시흥남동,12585,5761,2.18,6311,6274,1.01
2556,4513065000,전라북도군산시조촌동,24159,10492,2.3,12236,11923,1.03
2557,4513066000,전라북도군산시경암동,7344,3960,1.85,3672,3672,1.0
2558,4513067000,전라북도군산시구암동,8119,3761,2.16,4074,4045,1.01
2559,4513068000,전라북도군산시개정동,2802,1219,2.3,1425,1377,1.03
2560,4513069000,전라북도군산시수송동,54888,21081,2.6,27400,27488,1.0
2561,4513070100,전라북도군산시나운1동,12401,5866,2.11,6182,6219,0.99
2562,4513070200,전라북도군산시나운2동,23117,9691,2.39,11184,11933,0.94
2563,4513070300,전라북도군산시나운3동,31751,13922,2.28,15824,15927,0.99
2564,4513071000,전라북도군산시소룡동,17222,8961,1.92,9495,7727,1.23
2565,4513072000,전라북도군산시미성동,11392,6660,1.71,6337,5055,1.25
2566,4514000000,전라북도익산시,278113,129962,2.14,138427,139686,0.99
2567,4514025000,전라북도익산시함열읍,6708,3342,2.01,3271,3437,0.95
2568,4514031000,전라북도익산시오산면,7692,3871,1.99,3789,3903,0.97
2569,4514032000,전라북도익산시황등면,6977,3407,2.05,3516,3461,1.02
2570,4514033000,전라북도익산시함라면,2256,1217,1.85,1126,1130,1.0
2571,4514034000,전라북도익산시웅포면,1520,850,1.79,772,748,1.03
2572,4514035000,전라북도익산시성당면,1900,1052,1.81,958,942,1.02
2573,4514036000,전라북도익산시용안면,2627,1470,1.79,1308,1319,0.99
2574,4514037000,전라북도익산시낭산면,3002,1600,1.88,1583,1419,1.12
2575,4514038000,전라북도익산시망성면,2942,1689,1.74,1448,1494,0.97
2576,4514039000,전라북도익산시여산면,3270,1789,1.83,1662,1608,1.03
2577,4514040000,전라북도익산시금마면,5200,2520,2.06,2711,2489,1.09
2578,4514041000,전라북도익산시왕궁면,4290,2504,1.71,2195,2095,1.05
2579,4514042000,전라북도익산시춘포면,4386,2344,1.87,2257,2129,1.06
2580,4514043000,전라북도익산시삼기면,2581,1316,1.96,1343,1238,1.08
2581,4514044000,전라북도익산시용동면,1525,830,1.84,752,773,0.97
2582,4514052000,전라북도익산시중앙동,3278,2047,1.6,1753,1525,1.15
2583,4514053000,전라북도익산시평화동,4685,2426,1.93,2488,2197,1.13
2584,4514056000,전라북도익산시인화동,6866,3745,1.83,3531,3335,1.06
2585,4514057000,전라북도익산시동산동,22273,10331,2.16,10930,11343,0.96
2586,4514058000,전라북도익산시마동,9247,4646,1.99,4693,4554,1.03
2587,4514059500,전라북도익산시남중동,11347,5965,1.9,5818,5529,1.05
2588,4514061000,전라북도익산시모현동,38963,16091,2.42,18829,20134,0.94
2589,4514062000,전라북도익산시송학동,8537,3579,2.39,4225,4312,0.98
2590,4514064600,전라북도익산시영등1동,22816,9620,2.37,11250,11566,0.97
2591,4514064700,전라북도익산시영등2동,14065,5696,2.47,6886,7179,0.96
2592,4514065200,전라북도익산시어양동,24736,10493,2.36,12091,12645,0.96
2593,4514065600,전라북도익산시신동,15377,9120,1.69,7714,7663,1.01
2594,4514067000,전라북도익산시팔봉동,6550,2808,2.33,3395,3155,1.08
2595,4514069000,전라북도익산시삼성동,32497,13594,2.39,16133,16364,0.99
2596,4514500000,전라북도익산시함열출장소,0,0,0.0,0,0,0.0
2597,4518000000,전라북도정읍시,106487,54242,1.96,52892,53595,0.99
2598,4518025000,전라북도정읍시신태인읍,5365,2972,1.81,2622,2743,0.96
2599,4518031000,전라북도정읍시북면,4182,2229,1.88,2126,2056,1.03
2600,4518032000,전라북도정읍시입암면,2792,1647,1.7,1394,1398,1.0
2601,4518033000,전라북도정읍시소성면,2081,1237,1.68,1078,1003,1.07
2602,4518034000,전라북도정읍시고부면,2760,1585,1.74,1372,1388,0.99
2603,4518035000,전라북도정읍시영원면,1737,1045,1.66,857,880,0.97
2604,4518036000,전라북도정읍시덕천면,1771,1000,1.77,888,883,1.01
2605,4518037000,전라북도정읍시이평면,2031,1267,1.6,999,1032,0.97
2606,4518038000,전라북도정읍시정우면,2507,1468,1.71,1271,1236,1.03
2607,4518039000,전라북도정읍시태인면,3375,2022,1.67,1686,1689,1.0
2608,4518040000,전라북도정읍시감곡면,2793,1727,1.62,1415,1378,1.03
2609,4518041000,전라북도정읍시옹동면,1655,1010,1.64,841,814,1.03
2610,4518042000,전라북도정읍시칠보면,2251,1254,1.8,1156,1095,1.06
2611,4518043000,전라북도정읍시산내면,1200,731,1.64,606,594,1.02
2612,4518044000,전라북도정읍시산외면,2083,1261,1.65,1049,1034,1.01
2613,4518051000,전라북도정읍시수성동,17083,8336,2.05,8644,8439,1.02
2614,4518052000,전라북도정읍시장명동,2951,1443,2.05,1444,1507,0.96
2615,4518053500,전라북도정읍시내장상동,20342,8633,2.36,9822,10520,0.93
2616,4518054500,전라북도정읍시시기동,3217,1663,1.93,1549,1668,0.93
2617,4518056500,전라북도정읍시초산동,10247,4229,2.42,5066,5181,0.98
2618,4518057000,전라북도정읍시연지동,6049,3005,2.01,3013,3036,0.99
2619,4518058000,전라북도정읍시농소동,4049,2155,1.88,1936,2113,0.92
2620,4518059500,전라북도정읍시상교동,3966,2323,1.71,2058,1908,1.08
2621,4519000000,전라북도남원시,79431,39670,2.0,38965,40466,0.96
2622,4519025000,전라북도남원시운봉읍,3848,2094,1.84,1871,1977,0.95
2623,4519031000,전라북도남원시주천면,2609,1358,1.92,1334,1275,1.05
2624,4519032000,전라북도남원시수지면,1082,606,1.79,536,546,0.98
2625,4519033000,전라북도남원시송동면,2000,1075,1.86,999,1001,1.0
2626,4519034000,전라북도남원시주생면,1802,1030,1.75,885,917,0.97
2627,4519035000,전라북도남원시금지면,2273,1279,1.78,1091,1182,0.92
2628,4519036000,전라북도남원시대강면,1570,934,1.68,749,821,0.91
2629,4519037000,전라북도남원시대산면,1647,778,2.12,834,813,1.03
2630,4519038000,전라북도남원시사매면,1491,809,1.84,782,709,1.1
2631,4519039000,전라북도남원시덕과면,928,577,1.61,478,450,1.06
2632,4519040000,전라북도남원시보절면,1446,858,1.69,728,718,1.01
2633,4519041000,전라북도남원시산동면,1811,1026,1.77,910,901,1.01
2634,4519042000,전라북도남원시이백면,2261,1183,1.91,1106,1155,0.96
2635,4519045000,전라북도남원시아영면,1885,1021,1.85,925,960,0.96
2636,4519046000,전라북도남원시산내면,2108,1176,1.79,1040,1068,0.97
2637,4519047000,전라북도남원시인월면,2706,1486,1.82,1322,1384,0.96
2638,4519051000,전라북도남원시동충동,3373,1683,2.0,1596,1777,0.9
2639,4519052000,전라북도남원시죽항동,3289,1819,1.81,1548,1741,0.89
2640,4519054000,전라북도남원시노암동,6127,2864,2.14,2951,3176,0.93
2641,4519055000,전라북도남원시금동,6598,3124,2.11,3181,3417,0.93
2642,4519056000,전라북도남원시왕정동,4206,2058,2.04,2058,2148,0.96
2643,4519057000,전라북도남원시향교동,6984,3681,1.9,3547,3437,1.03
2644,4519059000,전라북도남원시도통동,17387,7151,2.43,8494,8893,0.96
2645,4521000000,전라북도김제시,80913,42509,1.9,40193,40720,0.99
2646,4521025000,전라북도김제시만경읍,2611,1527,1.71,1313,1298,1.01
2647,4521032000,전라북도김제시죽산면,2390,1404,1.7,1186,1204,0.99
2648,4521033000,전라북도김제시백산면,2448,1445,1.69,1310,1138,1.15
2649,4521034000,전라북도김제시용지면,3471,1904,1.82,1778,1693,1.05
2650,4521035000,전라북도김제시백구면,3704,2038,1.82,1810,1894,0.96
2651,4521036000,전라북도김제시부량면,1301,727,1.79,626,675,0.93
2652,4521038000,전라북도김제시공덕면,2457,1375,1.79,1255,1202,1.04
2653,4521039000,전라북도김제시청하면,1720,962,1.79,861,859,1.0
2654,4521040000,전라북도김제시성덕면,1737,1014,1.71,878,859,1.02
2655,4521041000,전라북도김제시진봉면,2543,1525,1.67,1231,1312,0.94
2656,4521042000,전라북도김제시금구면,4934,2586,1.91,2518,2416,1.04
2657,4521043000,전라북도김제시봉남면,2193,1320,1.66,1080,1113,0.97
2658,4521044000,전라북도김제시황산면,1876,1077,1.74,955,921,1.04
2659,4521045000,전라북도김제시금산면,4516,2672,1.69,2276,2240,1.02
2660,4521046000,전라북도김제시광활면,1321,742,1.78,685,636,1.08
2661,4521051000,전라북도김제시요촌동,10921,5482,1.99,5391,5530,0.97
2662,4521052000,전라북도김제시신풍동,12753,6032,2.11,6164,6589,0.94
2663,4521054000,전라북도김제시검산동,11688,5555,2.1,5719,5969,0.96
2664,4521058000,전라북도김제시교월동,6329,3122,2.03,3157,3172,1.0
2665,4571000000,전라북도완주군,91142,44020,2.07,46845,44297,1.06
2666,4571025000,전라북도완주군삼례읍,14339,7526,1.91,7412,6927,1.07
2667,4571025300,전라북도완주군봉동읍,26435,11222,2.36,13759,12676,1.09
2668,4571025600,전라북도완주군용진읍,6998,3450,2.03,3607,3391,1.06
2669,4571032000,전라북도완주군상관면,4321,2123,2.04,2223,2098,1.06
2670,4571033000,전라북도완주군이서면,14218,6663,2.13,7142,7076,1.01
2671,4571034000,전라북도완주군소양면,5996,2982,2.01,3102,2894,1.07
2672,4571035000,전라북도완주군구이면,5743,2954,1.94,2886,2857,1.01
2673,4571036000,전라북도완주군고산면,4568,2336,1.96,2340,2228,1.05
2674,4571037000,전라북도완주군비봉면,1847,1023,1.81,951,896,1.06
2675,4571038000,전라북도완주군운주면,1928,1176,1.64,971,957,1.01
2676,4571039000,전라북도완주군화산면,2685,1408,1.91,1394,1291,1.08
2677,4571040000,전라북도완주군동상면,1090,596,1.83,558,532,1.05
2678,4571041000,전라북도완주군경천면,974,561,1.74,500,474,1.05
2679,4572000000,전라북도진안군,24987,13494,1.85,12667,12320,1.03
2680,4572025000,전라북도진안군진안읍,9974,4988,2.0,5042,4932,1.02
2681,4572031000,전라북도진안군용담면,840,536,1.57,419,421,1.0
2682,4572032000,전라북도진안군안천면,1068,586,1.82,515,553,0.93
2683,4572033000,전라북도진안군동향면,1356,793,1.71,646,710,0.91
2684,4572034000,전라북도진안군상전면,849,483,1.76,434,415,1.05
2685,4572035000,전라북도진안군백운면,1950,1139,1.71,1017,933,1.09
2686,4572036000,전라북도진안군성수면,1757,1003,1.75,890,867,1.03
2687,4572037000,전라북도진안군마령면,1818,997,1.82,923,895,1.03
2688,4572038000,전라북도진안군부귀면,2834,1519,1.87,1468,1366,1.07
2689,4572039000,전라북도진안군정천면,1049,553,1.9,555,494,1.12
2690,4572040000,전라북도진안군주천면,1492,897,1.66,758,734,1.03
2691,4573000000,전라북도무주군,23748,12823,1.85,11826,11922,0.99
2692,4573025000,전라북도무주군무주읍,9426,4570,2.06,4697,4729,0.99
2693,4573031000,전라북도무주군무풍면,2186,1282,1.71,1088,1098,0.99
2694,4573032000,전라북도무주군설천면,3970,2228,1.78,2004,1966,1.02
2695,4573033000,전라북도무주군적상면,2576,1518,1.7,1259,1317,0.96
2696,4573034000,전라북도무주군안성면,4194,2390,1.75,2080,2114,0.98
2697,4573035000,전라북도무주군부남면,1396,835,1.67,698,698,1.0
2698,4574000000,전라북도장수군,21695,11584,1.87,10812,10883,0.99
2699,4574025000,전라북도장수군장수읍,7259,3579,2.03,3569,3690,0.97
2700,4574031000,전라북도장수군산서면,2048,1154,1.77,1030,1018,1.01
2701,4574032000,전라북도장수군번암면,2288,1324,1.73,1162,1126,1.03
2702,4574033500,전라북도장수군장계면,4335,2255,1.92,2181,2154,1.01
2703,4574034000,전라북도장수군천천면,2056,1201,1.71,1006,1050,0.96
2704,4574035000,전라북도장수군계남면,2144,1169,1.83,1070,1074,1.0
2705,4574036000,전라북도장수군계북면,1565,902,1.74,794,771,1.03
2706,4575000000,전라북도임실군,26730,14899,1.79,13692,13038,1.05
2707,4575025000,전라북도임실군임실읍,7334,3675,2.0,3726,3608,1.03
2708,4575031000,전라북도임실군청웅면,1256,757,1.66,631,625,1.01
2709,4575032000,전라북도임실군운암면,1594,949,1.68,841,753,1.12
2710,4575033000,전라북도임실군신평면,1426,850,1.68,732,694,1.05
2711,4575034000,전라북도임실군성수면,1634,947,1.73,850,784,1.08
2712,4575035500,전라북도임실군오수면,3558,1998,1.78,1803,1755,1.03
2713,4575036000,전라북도임실군신덕면,1313,776,1.69,684,629,1.09
2714,4575037000,전라북도임실군삼계면,1496,908,1.65,759,737,1.03
2715,4575038000,전라북도임실군관촌면,3237,1729,1.87,1659,1578,1.05
2716,4575039000,전라북도임실군강진면,1504,895,1.68,799,705,1.13
2717,4575040000,전라북도임실군덕치면,1190,731,1.63,609,581,1.05
2718,4575041000,전라북도임실군지사면,1188,684,1.74,599,589,1.02
2719,4577000000,전라북도순창군,26855,13996,1.92,13189,13666,0.97
2720,4577025000,전라북도순창군순창읍,10086,4526,2.23,4927,5159,0.96
2721,4577031000,전라북도순창군인계면,1494,831,1.8,731,763,0.96
2722,4577032000,전라북도순창군동계면,1963,1140,1.72,968,995,0.97
2723,4577033000,전라북도순창군풍산면,1668,955,1.75,838,830,1.01
2724,4577034000,전라북도순창군금과면,1681,971,1.73,844,837,1.01
2725,4577035000,전라북도순창군팔덕면,1373,751,1.83,697,676,1.03
2726,4577036000,전라북도순창군쌍치면,1927,1057,1.82,954,973,0.98
2727,4577037000,전라북도순창군복흥면,2119,1120,1.89,1030,1089,0.95
2728,4577038000,전라북도순창군적성면,1236,720,1.72,596,640,0.93
2729,4577039000,전라북도순창군유등면,1036,601,1.72,499,537,0.93
2730,4577040000,전라북도순창군구림면,2272,1324,1.72,1105,1167,0.95
2731,4579000000,전라북도고창군,53386,28757,1.86,26507,26879,0.99
2732,4579025000,전라북도고창군고창읍,21110,9581,2.2,10480,10630,0.99
2733,4579031000,전라북도고창군고수면,2226,1308,1.7,1148,1078,1.06
2734,4579032000,전라북도고창군아산면,2606,1582,1.65,1320,1286,1.03
2735,4579033000,전라북도고창군무장면,2716,1523,1.78,1346,1370,0.98
2736,4579034000,전라북도고창군공음면,2465,1475,1.67,1212,1253,0.97
2737,4579035000,전라북도고창군상하면,2386,1371,1.74,1170,1216,0.96
2738,4579036000,전라북도고창군해리면,2687,1604,1.68,1320,1367,0.97
2739,4579037000,전라북도고창군성송면,1767,1117,1.58,872,895,0.97
2740,4579038000,전라북도고창군대산면,3212,1955,1.64,1592,1620,0.98
2741,4579039000,전라북도고창군심원면,2450,1429,1.71,1230,1220,1.01
2742,4579040000,전라북도고창군흥덕면,3111,1783,1.74,1531,1580,0.97
2743,4579041000,전라북도고창군성내면,1908,1148,1.66,985,923,1.07
2744,4579042000,전라북도고창군신림면,2179,1293,1.69,1048,1131,0.93
2745,4579043000,전라북도고창군부안면,2563,1588,1.61,1253,1310,0.96
2746,4580000000,전라북도부안군,50795,27588,1.84,25262,25533,0.99
2747,4580025000,전라북도부안군부안읍,20837,9804,2.13,10178,10659,0.95
2748,4580031000,전라북도부안군주산면,1881,1130,1.66,923,958,0.96
2749,4580032000,전라북도부안군동진면,2767,1658,1.67,1397,1370,1.02
2750,4580033000,전라북도부안군행안면,2148,1261,1.7,1119,1029,1.09
2751,4580034000,전라북도부안군계화면,3303,1872,1.76,1666,1637,1.02
2752,4580035000,전라북도부안군보안면,2397,1479,1.62,1201,1196,1.0
2753,4580036000,전라북도부안군변산면,4357,2448,1.78,2232,2125,1.05
2754,4580037000,전라북도부안군진서면,2238,1334,1.68,1154,1084,1.06
2755,4580038000,전라북도부안군백산면,2460,1524,1.61,1214,1246,0.97
2756,4580039000,전라북도부안군상서면,2159,1293,1.67,1063,1096,0.97
2757,4580040000,전라북도부안군하서면,2601,1551,1.68,1272,1329,0.96
2758,4580041000,전라북도부안군줄포면,2521,1481,1.7,1244,1277,0.97
2759,4580042000,전라북도부안군위도면,1126,753,1.5,599,527,1.14
2760,4600000000,전라남도,1832803,903108,2.03,922221,910582,1.01
2761,4611000000,전라남도목포시,218589,103162,2.12,108808,109781,0.99
2762,4611051000,전라남도목포시용당1동,10218,5689,1.8,5121,5097,1.0
2763,4611052000,전라남도목포시용당2동,5015,2884,1.74,2517,2498,1.01
2764,4611053500,전라남도목포시연동,4578,2758,1.66,2327,2251,1.03
2765,4611054500,전라남도목포시산정동,9402,4095,2.3,4559,4843,0.94
2766,4611055400,전라남도목포시연산동,10472,4168,2.51,5165,5307,0.97
2767,4611055800,전라남도목포시원산동,12592,5955,2.11,6181,6411,0.96
2768,4611056500,전라남도목포시대성동,4938,2401,2.06,2439,2499,0.98
2769,4611059500,전라남도목포시목원동,7399,4411,1.68,3764,3635,1.04
2770,4611064000,전라남도목포시동명동,5208,2923,1.78,2719,2489,1.09
2771,4611064500,전라남도목포시삼학동,5945,2712,2.19,2918,3027,0.96
2772,4611065500,전라남도목포시만호동,2740,1769,1.55,1462,1278,1.14
2773,4611066000,전라남도목포시유달동,3970,2542,1.56,2119,1851,1.14
2774,4611069500,전라남도목포시죽교동,3023,1788,1.69,1563,1460,1.07
2775,4611070500,전라남도목포시북항동,9067,4323,2.1,4540,4527,1.0
2776,4611074500,전라남도목포시용해동,16799,7307,2.3,8257,8542,0.97
2777,4611075000,전라남도목포시이로동,10683,4278,2.5,5264,5419,0.97
2778,4611075600,전라남도목포시상동,21265,9562,2.22,10430,10835,0.96
2779,4611075700,전라남도목포시하당동,11744,6428,1.83,6062,5682,1.07
2780,4611075800,전라남도목포시신흥동,16363,7284,2.25,8132,8231,0.99
2781,4611078000,전라남도목포시삼향동,4676,2261,2.07,2336,2340,1.0
2782,4611079000,전라남도목포시옥암동,11313,4529,2.5,5439,5874,0.93
2783,4611080000,전라남도목포시부흥동,8152,3839,2.12,3978,4174,0.95
2784,4611081000,전라남도목포시부주동,23027,9256,2.49,11516,11511,1.0
2785,4613000000,전라남도여수시,276762,128169,2.16,141074,135688,1.04
2786,4613025000,전라남도여수시돌산읍,2607,1485,1.76,1308,1299,1.01
2787,4613025100,전라남도여수시돌산읍우두출장소,8573,4268,2.01,4487,4086,1.1
2788,4613025200,전라남도여수시돌산읍죽포출장소,1918,1064,1.8,934,984,0.95
2789,4613031000,전라남도여수시소라면,21526,9381,2.29,11006,10520,1.05
2790,4613032000,전라남도여수시율촌면,6161,3294,1.87,3203,2958,1.08
2791,4613033000,전라남도여수시화양면,6373,3563,1.79,3278,3095,1.06
2792,4613034000,전라남도여수시남면,2738,1669,1.64,1390,1348,1.03
2793,4613035000,전라남도여수시화정면,1331,811,1.64,663,668,0.99
2794,4613035600,전라남도여수시화정면개도출장소,788,473,1.67,395,393,1.01
2795,4613036000,전라남도여수시삼산면,2031,1269,1.6,1143,888,1.29
2796,4613051500,전라남도여수시동문동,4579,2552,1.79,2308,2271,1.02
2797,4613053500,전라남도여수시한려동,3071,1767,1.74,1525,1546,0.99
2798,4613057000,전라남도여수시중앙동,4243,2315,1.83,2126,2117,1.0
2799,4613060000,전라남도여수시충무동,3890,2202,1.77,1998,1892,1.06
2800,4613062500,전라남도여수시광림동,5927,3189,1.86,3066,2861,1.07
2801,4613063500,전라남도여수시서강동,3634,1878,1.94,1788,1846,0.97
2802,4613065500,전라남도여수시대교동,5237,3011,1.74,2651,2586,1.03
2803,4613067000,전라남도여수시국동,11140,5297,2.1,5606,5534,1.01
2804,4613068500,전라남도여수시월호동,6732,2886,2.33,3355,3377,0.99
2805,4613070000,전라남도여수시여서동,18292,7984,2.29,9042,9250,0.98
2806,4613071000,전라남도여수시문수동,20904,9546,2.19,10516,10388,1.01
2807,4613073000,전라남도여수시미평동,11522,5879,1.96,6160,5362,1.15
2808,4613074000,전라남도여수시둔덕동,10079,4090,2.46,5070,5009,1.01
2809,4613076500,전라남도여수시만덕동,10497,4516,2.32,5283,5214,1.01
2810,4613078000,전라남도여수시쌍봉동,31956,13576,2.35,16366,15590,1.05
2811,4613079000,전라남도여수시시전동,38337,14732,2.6,19226,19111,1.01
2812,4613080000,전라남도여수시여천동,21111,10446,2.02,11158,9953,1.12
2813,4613081000,전라남도여수시주삼동,8125,3130,2.6,4160,3965,1.05
2814,4613082000,전라남도여수시삼일동,2290,1280,1.79,1260,1030,1.22
2815,4613083000,전라남도여수시묘도동,1150,616,1.87,603,547,1.1
2816,4615000000,전라남도순천시,281436,124029,2.27,140466,140970,1.0
2817,4615025000,전라남도순천시승주읍,2640,1524,1.73,1306,1334,0.98
2818,4615031000,전라남도순천시해룡면,4464,2385,1.87,2308,2156,1.07
2819,4615031500,전라남도순천시해룡면상삼출장소,17902,7261,2.47,8827,9075,0.97
2820,4615031600,전라남도순천시해룡면신대출장소,33227,11424,2.91,16919,16308,1.04
2821,4615032000,전라남도순천시서면,12836,6355,2.02,6423,6413,1.0
2822,4615033000,전라남도순천시황전면,2919,1730,1.69,1477,1442,1.02
2823,4615034000,전라남도순천시월등면,1791,1031,1.74,857,934,0.92
2824,4615035000,전라남도순천시주암면,3107,1897,1.64,1563,1544,1.01
2825,4615036000,전라남도순천시송광면,1481,888,1.67,766,715,1.07
2826,4615037000,전라남도순천시외서면,848,523,1.62,412,436,0.94
2827,4615038000,전라남도순천시낙안면,3190,1756,1.82,1557,1633,0.95
2828,4615039000,전라남도순천시별량면,5484,2964,1.85,2737,2747,1.0
2829,4615040000,전라남도순천시상사면,2861,1483,1.93,1470,1391,1.06
2830,4615051500,전라남도순천시향동,3590,1885,1.9,1758,1832,0.96
2831,4615054000,전라남도순천시매곡동,6791,3464,1.96,3365,3426,0.98
2832,4615055000,전라남도순천시삼산동,25627,11109,2.31,12583,13044,0.96
2833,4615056000,전라남도순천시조곡동,6188,2927,2.11,3112,3076,1.01
2834,4615057000,전라남도순천시덕연동,43779,17851,2.45,21865,21914,1.0
2835,4615058000,전라남도순천시풍덕동,7640,3830,1.99,3798,3842,0.99
2836,4615059000,전라남도순천시남제동,8668,4419,1.96,4384,4284,1.02
2837,4615060000,전라남도순천시저전동,2679,1378,1.94,1304,1375,0.95
2838,4615061000,전라남도순천시장천동,2207,1411,1.56,1158,1049,1.1
2839,4615062000,전라남도순천시중앙동,2895,1618,1.79,1469,1426,1.03
2840,4615063500,전라남도순천시도사동,18260,7789,2.34,9205,9055,1.02
2841,4615066100,전라남도순천시왕조1동,41011,17530,2.34,20296,20715,0.98
2842,4615066500,전라남도순천시왕조2동,19351,7597,2.55,9547,9804,0.97
2843,4617000000,전라남도나주시,116726,59292,1.97,58906,57820,1.02
2844,4617025000,전라남도나주시남평읍,12040,6024,2.0,6051,5989,1.01
2845,4617031000,전라남도나주시세지면,2563,1560,1.64,1293,1270,1.02
2846,4617032000,전라남도나주시왕곡면,2838,1627,1.74,1484,1354,1.1
2847,4617033000,전라남도나주시반남면,1410,880,1.6,697,713,0.98
2848,4617034000,전라남도나주시공산면,2246,1341,1.67,1139,1107,1.03
2849,4617035000,전라남도나주시동강면,2406,1475,1.63,1196,1210,0.99
2850,4617036000,전라남도나주시다시면,3551,2142,1.66,1795,1756,1.02
2851,4617037000,전라남도나주시문평면,1901,1203,1.58,932,969,0.96
2852,4617038000,전라남도나주시노안면,4515,2625,1.72,2326,2189,1.06
2853,4617039000,전라남도나주시금천면,4174,2375,1.76,2191,1983,1.1
2854,4617040000,전라남도나주시산포면,3317,1990,1.67,1739,1578,1.1
2855,4617042000,전라남도나주시다도면,1861,1032,1.8,960,901,1.07
2856,4617043000,전라남도나주시봉황면,4138,2520,1.64,2142,1996,1.07
2857,4617051000,전라남도나주시송월동,7811,3887,2.01,3881,3930,0.99
2858,4617052000,전라남도나주시영강동,2652,1446,1.83,1312,1340,0.98
2859,4617054000,전라남도나주시금남동,4859,2638,1.84,2440,2419,1.01
2860,4617055000,전라남도나주시성북동,8709,4100,2.12,4390,4319,1.02
2861,4617058000,전라남도나주시영산동,3155,1972,1.6,1585,1570,1.01
2862,4617060000,전라남도나주시이창동,3334,2012,1.66,1795,1539,1.17
2863,4617062000,전라남도나주시빛가람동,39246,16443,2.39,19558,19688,0.99
2864,4623000000,전라남도광양시,150531,67103,2.24,78626,71905,1.09
2865,4623025000,전라남도광양시광양읍,48325,21611,2.24,24763,23562,1.05
2866,4623031000,전라남도광양시봉강면,2147,1147,1.87,1115,1032,1.08
2867,4623032000,전라남도광양시옥룡면,3034,1714,1.77,1499,1535,0.98
2868,4623033000,전라남도광양시옥곡면,4979,2408,2.07,2565,2414,1.06
2869,4623034000,전라남도광양시진상면,2736,1587,1.72,1382,1354,1.02
2870,4623035000,전라남도광양시진월면,2747,1520,1.81,1365,1382,0.99
2871,4623036000,전라남도광양시다압면,1755,1014,1.73,881,874,1.01
2872,4623051500,전라남도광양시골약동,3732,1756,2.13,1998,1734,1.15
2873,4623053000,전라남도광양시중마동,56257,23007,2.45,29637,26620,1.11
2874,4623054000,전라남도광양시광영동,11717,5429,2.16,6197,5520,1.12
2875,4623055000,전라남도광양시금호동,11398,4967,2.29,6286,5112,1.23
2876,4623057000,전라남도광양시태인동,1704,943,1.81,938,766,1.22
2877,4671000000,전라남도담양군,46180,24773,1.86,23428,22752,1.03
2878,4671025000,전라남도담양군담양읍,15164,7513,2.02,7645,7519,1.02
2879,4671031000,전라남도담양군봉산면,2750,1541,1.78,1410,1340,1.05
2880,4671032000,전라남도담양군고서면,3108,1753,1.77,1576,1532,1.03
2881,4671033500,전라남도담양군가사문학면,1202,736,1.63,606,596,1.02
2882,4671034000,전라남도담양군창평면,3590,2050,1.75,1815,1775,1.02
2883,4671035000,전라남도담양군대덕면,1890,1103,1.71,988,902,1.1
2884,4671036000,전라남도담양군무정면,2647,1652,1.6,1459,1188,1.23
2885,4671037000,전라남도담양군금성면,2568,1499,1.71,1306,1262,1.03
2886,4671038000,전라남도담양군용면,1816,1024,1.77,913,903,1.01
2887,4671039000,전라남도담양군월산면,2414,1313,1.84,1216,1198,1.02
2888,4671040000,전라남도담양군수북면,4677,2320,2.02,2349,2328,1.01
2889,4671041000,전라남도담양군대전면,4354,2269,1.92,2145,2209,0.97
2890,4672000000,전라남도곡성군,27535,15536,1.77,13540,13995,0.97
2891,4672025000,전라남도곡성군곡성읍,7788,4010,1.94,3767,4021,0.94
2892,4672031000,전라남도곡성군오곡면,1852,1029,1.8,915,937,0.98
2893,4672032000,전라남도곡성군삼기면,1667,1015,1.64,820,847,0.97
2894,4672033000,전라남도곡성군석곡면,2293,1363,1.68,1084,1209,0.9
2895,4672034000,전라남도곡성군목사동면,1307,839,1.56,644,663,0.97
2896,4672035000,전라남도곡성군죽곡면,1882,1125,1.67,919,963,0.95
2897,4672036000,전라남도곡성군고달면,1155,701,1.65,576,579,0.99
2898,4672037000,전라남도곡성군옥과면,4110,2213,1.86,2056,2054,1.0
2899,4672038000,전라남도곡성군입면,2400,1359,1.77,1217,1183,1.03
2900,4672039000,전라남도곡성군겸면,1670,1031,1.62,821,849,0.97
2901,4672040000,전라남도곡성군오산면,1411,851,1.66,721,690,1.04
2902,4673000000,전라남도구례군,25235,13462,1.87,12285,12950,0.95
2903,4673025000,전라남도구례군구례읍,10730,5288,2.03,5215,5515,0.95
2904,4673031000,전라남도구례군문척면,1268,707,1.79,640,628,1.02
2905,4673032000,전라남도구례군간전면,1491,894,1.67,730,761,0.96
2906,4673033000,전라남도구례군토지면,2513,1456,1.73,1237,1276,0.97
2907,4673034000,전라남도구례군마산면,2614,1373,1.9,1280,1334,0.96
2908,4673035000,전라남도구례군광의면,2243,1285,1.75,1069,1174,0.91
2909,4673036000,전라남도구례군용방면,1432,819,1.75,691,741,0.93
2910,4673037000,전라남도구례군산동면,2944,1640,1.8,1423,1521,0.94
2911,4677000000,전라남도고흥군,62762,35379,1.77,30569,32193,0.95
2912,4677025000,전라남도고흥군고흥읍,12432,5910,2.1,6133,6299,0.97
2913,4677025300,전라남도고흥군도양읍,9629,5002,1.93,4718,4911,0.96
2914,4677025400,전라남도고흥군도양읍소록출장소,609,450,1.35,303,306,0.99
2915,4677025500,전라남도고흥군도양읍시산출장소,223,142,1.57,116,107,1.08
2916,4677031000,전라남도고흥군풍양면,3085,1839,1.68,1524,1561,0.98
2917,4677032000,전라남도고흥군도덕면,2904,1733,1.68,1402,1502,0.93
2918,4677033000,전라남도고흥군금산면,4252,2534,1.68,2076,2176,0.95
2919,4677034000,전라남도고흥군도화면,3798,2281,1.67,1839,1959,0.94
2920,4677035000,전라남도고흥군포두면,4827,2870,1.68,2337,2490,0.94
2921,4677036000,전라남도고흥군봉래면,1857,1097,1.69,919,938,0.98
2922,4677037000,전라남도고흥군점암면,2638,1686,1.56,1251,1387,0.9
2923,4677038000,전라남도고흥군과역면,3276,1894,1.73,1563,1713,0.91
2924,4677039000,전라남도고흥군남양면,2260,1366,1.65,1074,1186,0.91
2925,4677040000,전라남도고흥군동강면,3076,1805,1.7,1496,1580,0.95
2926,4677041000,전라남도고흥군대서면,2221,1373,1.62,1089,1132,0.96
2927,4677042000,전라남도고흥군두원면,2976,1798,1.66,1408,1568,0.9
2928,4677044000,전라남도고흥군영남면,1251,762,1.64,590,661,0.89
2929,4677045000,전라남도고흥군동일면,1448,837,1.73,731,717,1.02
2930,4678000000,전라남도보성군,39375,22511,1.75,19221,20154,0.95
2931,4678025000,전라남도보성군보성읍,8866,4479,1.98,4338,4528,0.96
2932,4678025300,전라남도보성군벌교읍,11474,6416,1.79,5598,5876,0.95
2933,4678031000,전라남도보성군노동면,1089,709,1.54,525,564,0.93
2934,4678032000,전라남도보성군미력면,1417,844,1.68,707,710,1.0
2935,4678033000,전라남도보성군겸백면,1143,718,1.59,553,590,0.94
2936,4678034000,전라남도보성군율어면,1177,702,1.68,579,598,0.97
2937,4678035000,전라남도보성군복내면,1641,999,1.64,781,860,0.91
2938,4678036000,전라남도보성군문덕면,893,588,1.52,456,437,1.04
2939,4678037000,전라남도보성군조성면,3633,2229,1.63,1745,1888,0.92
2940,4678038000,전라남도보성군득량면,2731,1681,1.62,1337,1394,0.96
2941,4678038500,전라남도보성군득량면예당출장소,1226,706,1.74,592,634,0.93
2942,4678039000,전라남도보성군회천면,3016,1772,1.7,1489,1527,0.98
2943,4678040000,전라남도보성군웅치면,1069,668,1.6,521,548,0.95
2944,4679000000,전라남도화순군,62624,32012,1.96,30910,31714,0.97
2945,4679025000,전라남도화순군화순읍,39707,18030,2.2,19477,20230,0.96
2946,4679031000,전라남도화순군한천면,924,572,1.62,476,448,1.06
2947,4679031500,전라남도화순군한천면영외출장소,424,277,1.53,200,224,0.89
2948,4679032000,전라남도화순군춘양면,1755,1097,1.6,896,859,1.04
2949,4679033000,전라남도화순군청풍면,1040,711,1.46,504,536,0.94
2950,4679034000,전라남도화순군이양면,1778,1140,1.56,871,907,0.96
2951,4679035000,전라남도화순군능주면,3186,1716,1.86,1567,1619,0.97
2952,4679036000,전라남도화순군도곡면,2850,1671,1.71,1422,1428,1.0
2953,4679037000,전라남도화순군도암면,1426,883,1.61,727,699,1.04
2954,4679038000,전라남도화순군이서면,949,598,1.59,490,459,1.07
2955,4679039500,전라남도화순군백아면,1577,1027,1.54,783,794,0.99
2956,4679040000,전라남도화순군동복면,1595,995,1.6,756,839,0.9
2957,4679041500,전라남도화순군사평면,2120,1306,1.62,1069,1051,1.02
2958,4679042000,전라남도화순군동면,3293,1989,1.66,1672,1621,1.03
2959,4680000000,전라남도장흥군,36547,20103,1.82,17785,18762,0.95
2960,4680025000,전라남도장흥군장흥읍,14916,7356,2.03,7289,7627,0.96
2961,4680025300,전라남도장흥군관산읍,4851,2825,1.72,2348,2503,0.94
2962,4680025600,전라남도장흥군대덕읍,3272,1922,1.7,1573,1699,0.93
2963,4680031000,전라남도장흥군용산면,2303,1336,1.72,1118,1185,0.94
2964,4680032000,전라남도장흥군안양면,2795,1654,1.69,1359,1436,0.95
2965,4680033000,전라남도장흥군장동면,1217,722,1.69,593,624,0.95
2966,4680034000,전라남도장흥군장평면,2073,1316,1.58,986,1087,0.91
2967,4680035000,전라남도장흥군유치면,1028,664,1.55,517,511,1.01
2968,4680036000,전라남도장흥군부산면,1386,837,1.66,679,707,0.96
2969,4680037000,전라남도장흥군회진면,2706,1471,1.84,1323,1383,0.96
2970,4681000000,전라남도강진군,33753,18592,1.82,16359,17394,0.94
2971,4681025000,전라남도강진군강진읍,13256,6662,1.99,6394,6862,0.93
2972,4681031000,전라남도강진군군동면,4407,2307,1.91,2134,2273,0.94
2973,4681032000,전라남도강진군칠량면,2232,1323,1.69,1081,1151,0.94
2974,4681033000,전라남도강진군대구면,1120,693,1.62,535,585,0.91
2975,4681034000,전라남도강진군도암면,2435,1459,1.67,1180,1255,0.94
2976,4681035000,전라남도강진군신전면,1765,1034,1.71,855,910,0.94
2977,4681036000,전라남도강진군성전면,2748,1604,1.71,1355,1393,0.97
2978,4681037000,전라남도강진군작천면,1811,1118,1.62,886,925,0.96
2979,4681038000,전라남도강진군병영면,1595,970,1.64,753,842,0.89
2980,4681039000,전라남도강진군옴천면,620,395,1.57,309,311,0.99
2981,4681040000,전라남도강진군마량면,1764,1027,1.72,877,887,0.99
2982,4682000000,전라남도해남군,67166,35225,1.91,33273,33893,0.98
2983,4682025000,전라남도해남군해남읍,24523,11134,2.2,12032,12491,0.96
2984,4682031000,전라남도해남군삼산면,2882,1609,1.79,1447,1435,1.01
2985,4682032000,전라남도해남군화산면,3130,1748,1.79,1550,1580,0.98
2986,4682033000,전라남도해남군현산면,2759,1583,1.74,1374,1385,0.99
2987,4682034000,전라남도해남군송지면,6004,3250,1.85,2950,3054,0.97
2988,4682035000,전라남도해남군북평면,2767,1548,1.79,1344,1423,0.94
2989,4682036000,전라남도해남군북일면,1949,1115,1.75,932,1017,0.92
2990,4682037000,전라남도해남군옥천면,2925,1686,1.73,1467,1458,1.01
2991,4682038000,전라남도해남군계곡면,2096,1255,1.67,994,1102,0.9
2992,4682039000,전라남도해남군마산면,2339,1387,1.69,1190,1149,1.04
2993,4682040000,전라남도해남군황산면,4645,2596,1.79,2301,2344,0.98
2994,4682041000,전라남도해남군산이면,3674,2102,1.75,1879,1795,1.05
2995,4682042000,전라남도해남군문내면,3939,2139,1.84,1975,1964,1.01
2996,4682043000,전라남도해남군화원면,3534,2073,1.7,1838,1696,1.08
2997,4683000000,전라남도영암군,52937,28197,1.88,27485,25452,1.08
2998,4683025000,전라남도영암군영암읍,8021,3880,2.07,3966,4055,0.98
2999,4683025300,전라남도영암군삼호읍,15134,7248,2.09,8103,7031,1.15
3000,4683025400,전라남도영암군삼호읍서부출장소,6357,3237,1.96,3735,2622,1.42
3001,4683031000,전라남도영암군덕진면,1823,1082,1.68,911,912,1.0
3002,4683032000,전라남도영암군금정면,2034,1222,1.66,1026,1008,1.02
3003,4683033000,전라남도영암군신북면,3658,2230,1.64,1835,1823,1.01
3004,4683034000,전라남도영암군시종면,3441,2158,1.59,1745,1696,1.03
3005,4683035000,전라남도영암군도포면,2241,1339,1.67,1156,1085,1.07
3006,4683036000,전라남도영암군군서면,3161,1848,1.71,1532,1629,0.94
3007,4683037000,전라남도영암군서호면,1878,1099,1.71,907,971,0.93
3008,4683038000,전라남도영암군학산면,2984,1603,1.86,1452,1532,0.95
3009,4683039000,전라남도영암군미암면,2205,1251,1.76,1117,1088,1.03
3010,4684000000,전라남도무안군,91107,42739,2.13,45753,45354,1.01
3011,4684025000,전라남도무안군무안읍,10946,5500,1.99,5488,5458,1.01
3012,4684025300,전라남도무안군일로읍,16432,6734,2.44,8185,8247,0.99
3013,4684025600,전라남도무안군삼향읍,5442,2535,2.15,2877,2565,1.12
3014,4684025800,전라남도무안군삼향읍남악출장소,34777,14190,2.45,17201,17576,0.98
3015,4684032000,전라남도무안군몽탄면,3088,1872,1.65,1542,1546,1.0
3016,4684033000,전라남도무안군청계면,6291,3601,1.75,3256,3035,1.07
3017,4684034000,전라남도무안군현경면,4512,2733,1.65,2292,2220,1.03
3018,4684035000,전라남도무안군망운면,1920,1108,1.73,992,928,1.07
3019,4684036000,전라남도무안군해제면,4826,2837,1.7,2448,2378,1.03
3020,4684037000,전라남도무안군운남면,2873,1629,1.76,1472,1401,1.05
3021,4686000000,전라남도함평군,31274,17980,1.74,15730,15544,1.01
3022,4686025000,전라남도함평군함평읍,8274,4305,1.92,4083,4191,0.97
3023,4686031000,전라남도함평군손불면,3338,1964,1.7,1684,1654,1.02
3024,4686032000,전라남도함평군신광면,1785,1092,1.63,881,904,0.97
3025,4686033000,전라남도함평군학교면,3685,2238,1.65,1846,1839,1.0
3026,4686034000,전라남도함평군엄다면,1856,1134,1.64,909,947,0.96
3027,4686035000,전라남도함평군대동면,3076,1831,1.68,1596,1480,1.08
3028,4686036000,전라남도함평군나산면,2785,1686,1.65,1377,1408,0.98
3029,4686037000,전라남도함평군해보면,2783,1602,1.74,1412,1371,1.03
3030,4686038000,전라남도함평군월야면,3692,2128,1.73,1942,1750,1.11
3031,4687000000,전라남도영광군,51985,27112,1.92,25959,26026,1.0
3032,4687025000,전라남도영광군영광읍,21737,10130,2.15,10678,11059,0.97
3033,4687025300,전라남도영광군백수읍,4543,2659,1.71,2267,2276,1.0
3034,4687025600,전라남도영광군홍농읍,6597,3378,1.95,3477,3120,1.11
3035,4687031000,전라남도영광군대마면,1731,1036,1.67,913,818,1.12
3036,4687032000,전라남도영광군묘량면,1733,991,1.75,854,879,0.97
3037,4687033000,전라남도영광군불갑면,1341,737,1.82,671,670,1.0
3038,4687034000,전라남도영광군군서면,2290,1240,1.85,1161,1129,1.03
3039,4687035000,전라남도영광군군남면,2349,1420,1.65,1130,1219,0.93
3040,4687036000,전라남도영광군염산면,3946,2389,1.65,1920,2026,0.95
3041,4687037000,전라남도영광군법성면,5146,2732,1.88,2537,2609,0.97
3042,4687038000,전라남도영광군낙월면,381,273,1.4,238,143,1.66
3043,4687038500,전라남도영광군낙월면안마출장소,191,127,1.5,113,78,1.45
3044,4688000000,전라남도장성군,43365,23160,1.87,22206,21159,1.05
3045,4688025000,전라남도장성군장성읍,13334,6632,2.01,6610,6724,0.98
3046,4688031000,전라남도장성군진원면,3639,1804,2.02,1840,1799,1.02
3047,4688032000,전라남도장성군남면,3699,2219,1.67,1999,1700,1.18
3048,4688033000,전라남도장성군동화면,1785,1060,1.68,944,841,1.12
3049,4688034000,전라남도장성군삼서면,3112,1768,1.76,1677,1435,1.17
3050,4688035000,전라남도장성군삼계면,5902,2880,2.05,3099,2803,1.11
3051,4688036000,전라남도장성군황룡면,3990,2190,1.82,2027,1963,1.03
3052,4688037000,전라남도장성군서삼면,1531,878,1.74,787,744,1.06
3053,4688038000,전라남도장성군북일면,1384,824,1.68,697,687,1.01
3054,4688039000,전라남도장성군북이면,2814,1571,1.79,1406,1408,1.0
3055,4688040000,전라남도장성군북하면,2175,1334,1.63,1120,1055,1.06
3056,4689000000,전라남도완도군,48631,26029,1.87,24475,24156,1.01
3057,4689025000,전라남도완도군완도읍,17987,8957,2.01,9059,8928,1.01
3058,4689025300,전라남도완도군금일읍,3629,2074,1.75,1835,1794,1.02
3059,4689025600,전라남도완도군노화읍,4277,2203,1.94,2137,2140,1.0
3060,4689029000,전라남도완도군노화읍넙도출장소,761,422,1.8,418,343,1.22
3061,4689031000,전라남도완도군군외면,3137,1903,1.65,1572,1565,1.0
3062,4689032000,전라남도완도군신지면,3312,1852,1.79,1687,1625,1.04
3063,4689033000,전라남도완도군고금면,4151,2352,1.76,2030,2121,0.96
3064,4689034000,전라남도완도군약산면,2279,1320,1.73,1158,1121,1.03
3065,4689035000,전라남도완도군청산면,2059,1207,1.71,1008,1051,0.96
3066,4689035500,전라남도완도군청산면모도출장소,221,134,1.65,118,103,1.15
3067,4689036000,전라남도완도군소안면,2436,1287,1.89,1211,1225,0.99
3068,4689037000,전라남도완도군금당면,969,551,1.76,482,487,0.99
3069,4689038000,전라남도완도군보길면,2603,1263,2.06,1328,1275,1.04
3070,4689039000,전라남도완도군생일면,810,504,1.61,432,378,1.14
3071,4690000000,전라남도진도군,30066,16700,1.8,14908,15158,0.98
3072,4690025000,전라남도진도군진도읍,10749,5314,2.02,5292,5457,0.97
3073,4690031000,전라남도진도군군내면,2955,1714,1.72,1493,1462,1.02
3074,4690032000,전라남도진도군고군면,3572,1944,1.84,1747,1825,0.96
3075,4690033000,전라남도진도군의신면,3432,2066,1.66,1756,1676,1.05
3076,4690034000,전라남도진도군임회면,3388,2008,1.69,1648,1740,0.95
3077,4690035000,전라남도진도군지산면,3065,1858,1.65,1474,1591,0.93
3078,4690036000,전라남도진도군조도면,2262,1420,1.59,1165,1097,1.06
3079,4690036500,전라남도진도군조도면가사출장소,261,165,1.58,139,122,1.14
3080,4690036600,전라남도진도군조도면거차출장소,382,211,1.81,194,188,1.03
3081,4691000000,전라남도신안군,38217,21843,1.75,20455,17762,1.15
3082,4691025000,전라남도신안군지도읍,4198,2422,1.73,2206,1992,1.11
3083,4691025100,전라남도신안군지도읍선도출장소,234,152,1.54,120,114,1.05
3084,4691025300,전라남도신안군압해읍,5672,2810,2.02,3092,2580,1.2
3085,4691025400,전라남도신안군압해읍매화출장소,226,152,1.49,114,112,1.02
3086,4691025500,전라남도신안군압해읍고이도출장소,217,130,1.67,124,93,1.33
3087,4691031000,전라남도신안군증도면,1455,907,1.6,802,653,1.23
3088,4691031500,전라남도신안군증도면병풍출장소,312,179,1.74,178,134,1.33
3089,4691032000,전라남도신안군임자면,3190,1816,1.76,1687,1503,1.12
3090,4691033000,전라남도신안군자은면,2285,1313,1.74,1214,1071,1.13
3091,4691034000,전라남도신안군비금면,3459,1922,1.8,1837,1622,1.13
3092,4691035000,전라남도신안군도초면,2467,1449,1.7,1264,1203,1.05
3093,4691035500,전라남도신안군도초면우이도출장소,219,146,1.5,127,92,1.38
3094,4691036000,전라남도신안군흑산면,2173,1359,1.6,1221,952,1.28
3095,4691036500,전라남도신안군흑산면가거도출장소,426,303,1.41,269,157,1.71
3096,4691036600,전라남도신안군흑산면태도출장소,193,131,1.47,114,79,1.44
3097,4691036700,전라남도신안군흑산면홍도출장소,448,250,1.79,251,197,1.27
3098,4691036800,전라남도신안군흑산면대둔도출장소,300,193,1.55,178,122,1.46
3099,4691037000,전라남도신안군하의면,1699,1007,1.69,912,787,1.16
3100,4691038000,전라남도신안군신의면,1529,797,1.92,830,699,1.19
3101,4691039000,전라남도신안군장산면,1520,939,1.62,807,713,1.13
3102,4691040000,전라남도신안군안좌면,2752,1631,1.69,1433,1319,1.09
3103,4691040500,전라남도신안군안좌면자라출장소,285,157,1.82,154,131,1.18
3104,4691041000,전라남도신안군팔금면,969,600,1.62,485,484,1.0
3105,4691042000,전라남도신안군암태면,1989,1078,1.85,1036,953,1.09
3106,4700000000,경상북도,2626609,1276846,2.06,1323661,1302948,1.02
3107,4711000000,경상북도포항시,503852,232201,2.17,255292,248560,1.03
3108,4711100000,경상북도포항시남구,230801,109419,2.11,119438,111363,1.07
3109,4711125000,경상북도포항시남구구룡포읍,7335,4563,1.61,3699,3636,1.02
3110,4711125300,경상북도포항시남구연일읍,30278,12332,2.46,15421,14857,1.04
3111,4711125600,경상북도포항시남구오천읍,56185,26311,2.14,30070,26115,1.15
3112,4711131000,경상북도포항시남구대송면,3396,1902,1.79,1764,1632,1.08
3113,4711132000,경상북도포항시남구동해면,9763,4733,2.06,4913,4850,1.01
3114,4711133000,경상북도포항시남구장기면,4038,2425,1.67,1974,2064,0.96
3115,4711135000,경상북도포항시남구호미곶면,1871,1176,1.59,928,943,0.98
3116,4711152500,경상북도포항시남구상대동,24717,13571,1.82,12828,11889,1.08
3117,4711154500,경상북도포항시남구해도동,17140,9873,1.74,8809,8331,1.06
3118,4711155000,경상북도포항시남구송도동,12172,6537,1.86,6082,6090,1.0
3119,4711156000,경상북도포항시남구청림동,4736,2660,1.78,2564,2172,1.18
3120,4711157000,경상북도포항시남구제철동,3007,1722,1.75,1822,1185,1.54
3121,4711158000,경상북도포항시남구효곡동,30598,11327,2.7,15571,15027,1.04
3122,4711159000,경상북도포항시남구대이동,25565,10287,2.49,12993,12572,1.03
3123,4711300000,경상북도포항시북구,273051,122782,2.22,135854,137197,0.99
3124,4711325000,경상북도포항시북구흥해읍,40958,18142,2.26,20538,20420,1.01
3125,4711331000,경상북도포항시북구신광면,2928,1696,1.73,1455,1473,0.99
3126,4711332000,경상북도포항시북구청하면,4760,2772,1.72,2338,2422,0.97
3127,4711333000,경상북도포항시북구송라면,2499,1551,1.61,1208,1291,0.94
3128,4711334000,경상북도포항시북구기계면,4968,2724,1.82,2414,2554,0.95
3129,4711335000,경상북도포항시북구죽장면,2140,1382,1.55,1069,1071,1.0
3130,4711335500,경상북도포항시북구죽장면상옥출장소,609,359,1.7,304,305,1.0
3131,4711336000,경상북도포항시북구기북면,1310,760,1.72,646,664,0.97
3132,4711352000,경상북도포항시북구중앙동,15484,8793,1.76,7613,7871,0.97
3133,4711363000,경상북도포항시북구양학동,16808,6926,2.43,8343,8465,0.99
3134,4711365500,경상북도포항시북구죽도동,19951,11528,1.73,9838,10113,0.97
3135,4711366500,경상북도포항시북구용흥동,21936,9526,2.3,10724,11212,0.96
3136,4711368000,경상북도포항시북구우창동,33437,14151,2.36,16355,17082,0.96
3137,4711369000,경상북도포항시북구두호동,23048,9227,2.5,11397,11651,0.98
3138,4711370000,경상북도포항시북구장량동,72666,29299,2.48,36901,35765,1.03
3139,4711371000,경상북도포항시북구환여동,9549,3946,2.42,4711,4838,0.97
3140,4713000000,경상북도경주시,251889,123071,2.05,126024,125865,1.0
3141,4713025000,경상북도경주시감포읍,5391,3189,1.69,2698,2693,1.0
3142,4713025300,경상북도경주시안강읍,24083,12102,1.99,11879,12204,0.97
3143,4713025600,경상북도경주시건천읍,9233,5085,1.82,4696,4537,1.04
3144,4713025900,경상북도경주시외동읍,22159,11853,1.87,11688,10471,1.12
3145,4713031500,경상북도경주시문무대왕면,4214,2307,1.83,2206,2008,1.1
3146,4713032000,경상북도경주시양남면,6277,3489,1.8,3338,2939,1.14
3147,4713033000,경상북도경주시내남면,4684,2674,1.75,2358,2326,1.01
3148,4713034000,경상북도경주시산내면,3230,2048,1.58,1597,1633,0.98
3149,4713035000,경상북도경주시서면,3116,1813,1.72,1555,1561,1.0
3150,4713036000,경상북도경주시현곡면,21699,8469,2.56,10669,11030,0.97
3151,4713037000,경상북도경주시강동면,6078,3452,1.76,3082,2996,1.03
3152,4713038000,경상북도경주시천북면,5677,2975,1.91,2963,2714,1.09
3153,4713051500,경상북도경주시중부동,5096,2870,1.78,2514,2582,0.97
3154,4713053000,경상북도경주시황오동,6307,3536,1.78,3048,3259,0.94
3155,4713055000,경상북도경주시성건동,13647,7701,1.77,6785,6862,0.99
3156,4713057000,경상북도경주시황남동,4485,2550,1.76,2214,2271,0.97
3157,4713059000,경상북도경주시선도동,14685,6519,2.25,7382,7303,1.01
3158,4713060500,경상북도경주시월성동,5836,2911,2.0,2873,2963,0.97
3159,4713061500,경상북도경주시용강동,24072,9700,2.48,11871,12201,0.97
3160,4713062100,경상북도경주시황성동,28310,11238,2.52,13895,14415,0.96
3161,4713063000,경상북도경주시동천동,22161,10449,2.12,11079,11082,1.0
3162,4713065000,경상북도경주시불국동,9725,5140,1.89,4781,4944,0.97
3163,4713066000,경상북도경주시보덕동,1724,1001,1.72,853,871,0.98
3164,4715000000,경상북도김천시,140239,68393,2.05,70305,69934,1.01
3165,4715025000,경상북도김천시아포읍,7800,3990,1.95,3899,3901,1.0
3166,4715031000,경상북도김천시농소면,3076,1578,1.95,1616,1460,1.11
3167,4715032000,경상북도김천시남면,3078,1715,1.79,1588,1490,1.07
3168,4715034000,경상북도김천시개령면,2407,1251,1.92,1229,1178,1.04
3169,4715035000,경상북도김천시감문면,3258,1852,1.76,1611,1647,0.98
3170,4715036000,경상북도김천시어모면,4013,2106,1.91,2052,1961,1.05
3171,4715037000,경상북도김천시봉산면,3065,1572,1.95,1579,1486,1.06
3172,4715038000,경상북도김천시대항면,3407,1754,1.94,1725,1682,1.03
3173,4715039000,경상북도김천시감천면,1936,981,1.97,997,939,1.06
3174,4715040000,경상북도김천시조마면,2178,1160,1.88,1091,1087,1.0
3175,4715041000,경상북도김천시구성면,2755,1632,1.69,1371,1384,0.99
3176,4715042000,경상북도김천시지례면,1531,905,1.69,767,764,1.0
3177,4715043000,경상북도김천시부항면,1236,740,1.67,620,616,1.01
3178,4715044000,경상북도김천시대덕면,2263,1420,1.59,1140,1123,1.02
3179,4715045000,경상북도김천시증산면,1033,632,1.63,494,539,0.92
3180,4715051600,경상북도김천시자산동,6551,3671,1.78,3320,3231,1.03
3181,4715053600,경상북도김천시평화남산동,7466,4190,1.78,3636,3830,0.95
3182,4715056500,경상북도김천시양금동,3816,2001,1.91,1860,1956,0.95
3183,4715057500,경상북도김천시대신동,25354,11457,2.21,12582,12772,0.99
3184,4715059500,경상북도김천시대곡동,20150,9493,2.12,10089,10061,1.0
3185,4715061000,경상북도김천시지좌동,10972,5249,2.09,5572,5400,1.03
3186,4715064000,경상북도김천시율곡동,22894,9044,2.53,11467,11427,1.0
3187,4717000000,경상북도안동시,156972,77666,2.02,77590,79382,0.98
3188,4717025000,경상북도안동시풍산읍,6378,3550,1.8,3232,3146,1.03
3189,4717031000,경상북도안동시와룡면,3981,2115,1.88,2047,1934,1.06
3190,4717032000,경상북도안동시북후면,2936,1735,1.69,1528,1408,1.09
3191,4717033000,경상북도안동시서후면,3473,1912,1.82,1840,1633,1.13
3192,4717034000,경상북도안동시풍천면,7012,4042,1.73,3569,3443,1.04
3193,4717035000,경상북도안동시일직면,2672,1508,1.77,1287,1385,0.93
3194,4717036000,경상북도안동시남후면,1717,988,1.74,856,861,0.99
3195,4717037000,경상북도안동시남선면,2080,1128,1.84,1070,1010,1.06
3196,4717038000,경상북도안동시임하면,2797,1728,1.62,1456,1341,1.09
3197,4717039000,경상북도안동시길안면,2691,1629,1.65,1351,1340,1.01
3198,4717040000,경상북도안동시임동면,1710,1031,1.66,887,823,1.08
3199,4717041000,경상북도안동시예안면,1823,1066,1.71,949,874,1.09
3200,4717042000,경상북도안동시도산면,1580,939,1.68,831,749,1.11
3201,4717043000,경상북도안동시녹전면,1724,972,1.77,891,833,1.07
3202,4717051000,경상북도안동시중구동,5085,2911,1.75,2473,2612,0.95
3203,4717052000,경상북도안동시명륜동,4917,2464,2.0,2367,2550,0.93
3204,4717055500,경상북도안동시용상동,22003,10459,2.1,10928,11075,0.99
3205,4717058500,경상북도안동시서구동,8956,4354,2.06,4301,4655,0.92
3206,4717060000,경상북도안동시태화동,13026,6490,2.01,6470,6556,0.99
3207,4717062000,경상북도안동시평화동,6280,2993,2.1,3043,3237,0.94
3208,4717063000,경상북도안동시안기동,6168,2820,2.19,3049,3119,0.98
3209,4717065000,경상북도안동시옥동,21296,9523,2.24,10117,11179,0.91
3210,4717066000,경상북도안동시송하동,16142,7089,2.28,7853,8289,0.95
3211,4717069000,경상북도안동시강남동,10525,4220,2.49,5195,5330,0.97
3212,4719000000,경상북도구미시,412581,182645,2.26,212021,200560,1.06
3213,4719025000,경상북도구미시선산읍,14623,6757,2.16,7231,7392,0.98
3214,4719025300,경상북도구미시고아읍,38162,14879,2.56,19296,18866,1.02
3215,4719025600,경상북도구미시산동읍,26902,10413,2.58,14027,12875,1.09
3216,4719031000,경상북도구미시무을면,1829,1026,1.78,908,921,0.99
3217,4719032000,경상북도구미시옥성면,1687,925,1.82,870,817,1.06
3218,4719033000,경상북도구미시도개면,2167,1155,1.88,1111,1056,1.05
3219,4719034000,경상북도구미시해평면,3997,2153,1.86,2094,1903,1.1
3220,4719036000,경상북도구미시장천면,3037,1575,1.93,1549,1488,1.04
3221,4719051000,경상북도구미시송정동,24087,10790,2.23,11859,12228,0.97
3222,4719053500,경상북도구미시원평동,6276,4282,1.47,3410,2866,1.19
3223,4719055100,경상북도구미시도량동,29123,11875,2.45,14220,14903,0.95
3224,4719055500,경상북도구미시지산동,2151,1070,2.01,1112,1039,1.07
3225,4719056500,경상북도구미시선주원남동,38893,16395,2.37,19732,19161,1.03
3226,4719058200,경상북도구미시형곡1동,14174,5882,2.41,7009,7165,0.98
3227,4719058300,경상북도구미시형곡2동,16583,7169,2.31,8319,8264,1.01
3228,4719059000,경상북도구미시신평1동,3254,1938,1.68,1825,1429,1.28
3229,4719060000,경상북도구미시신평2동,3104,1503,2.07,1685,1419,1.19
3230,4719061000,경상북도구미시비산동,13141,5509,2.39,6885,6256,1.1
3231,4719063000,경상북도구미시광평동,4279,2098,2.04,2310,1969,1.17
3232,4719064500,경상북도구미시상모사곡동,30997,13145,2.36,16149,14848,1.09
3233,4719066000,경상북도구미시임오동,18772,7433,2.53,9814,8958,1.1
3234,4719067000,경상북도구미시인동동,48057,22562,2.13,24935,23122,1.08
3235,4719068000,경상북도구미시진미동,16609,11243,1.48,9071,7538,1.2
3236,4719069000,경상북도구미시양포동,46262,18699,2.47,24154,22108,1.09
3237,4719070000,경상북도구미시공단동,4415,2169,2.04,2446,1969,1.24
3238,4721000000,경상북도영주시,101942,50271,2.03,50591,51351,0.99
3239,4721025000,경상북도영주시풍기읍,10485,5473,1.92,5214,5271,0.99
3240,4721031000,경상북도영주시이산면,2295,1197,1.92,1187,1108,1.07
3241,4721032000,경상북도영주시평은면,1422,787,1.81,725,697,1.04
3242,4721033000,경상북도영주시문수면,1938,1116,1.74,995,943,1.06
3243,4721034000,경상북도영주시장수면,2143,1163,1.84,1083,1060,1.02
3244,4721035000,경상북도영주시안정면,2962,1583,1.87,1486,1476,1.01
3245,4721036000,경상북도영주시봉현면,2700,1404,1.92,1375,1325,1.04
3246,4721037000,경상북도영주시순흥면,1983,1121,1.77,991,992,1.0
3247,4721038000,경상북도영주시단산면,1831,1075,1.7,903,928,0.97
3248,4721039000,경상북도영주시부석면,2995,1688,1.77,1494,1501,1.0
3249,4721051000,경상북도영주시상망동,7430,3467,2.14,3706,3724,1.0
3250,4721052500,경상북도영주시하망동,6007,2889,2.08,2866,3141,0.91
3251,4721055000,경상북도영주시영주1동,3912,2228,1.76,1924,1988,0.97
3252,4721056000,경상북도영주시영주2동,4915,2549,1.93,2361,2554,0.92
3253,4721059000,경상북도영주시휴천1동,6511,2796,2.33,3227,3284,0.98
3254,4721060000,경상북도영주시휴천2동,9837,5030,1.96,4861,4976,0.98
3255,4721061000,경상북도영주시휴천3동,7599,3549,2.14,3771,3828,0.99
3256,4721062000,경상북도영주시가흥1동,15303,6735,2.27,7702,7601,1.01
3257,4721063000,경상북도영주시가흥2동,9674,4421,2.19,4720,4954,0.95
3258,4723000000,경상북도영천시,101888,53904,1.89,51737,50151,1.03
3259,4723025000,경상북도영천시금호읍,10664,6162,1.73,5588,5076,1.1
3260,4723031000,경상북도영천시청통면,4045,2311,1.75,2110,1935,1.09
3261,4723032000,경상북도영천시신녕면,3753,2275,1.65,1843,1910,0.96
3262,4723033000,경상북도영천시화산면,3209,1816,1.77,1686,1523,1.11
3263,4723034000,경상북도영천시화북면,2179,1312,1.66,1081,1098,0.98
3264,4723035000,경상북도영천시화남면,3239,1880,1.72,1705,1534,1.11
3265,4723036000,경상북도영천시자양면,1203,758,1.59,595,608,0.98
3266,4723037000,경상북도영천시임고면,4190,2351,1.78,2132,2058,1.04
3267,4723038000,경상북도영천시고경면,5596,3363,1.66,3009,2587,1.16
3268,4723039000,경상북도영천시북안면,4419,2622,1.69,2298,2121,1.08
3269,4723040000,경상북도영천시대창면,3131,1848,1.69,1652,1479,1.12
3270,4723051000,경상북도영천시동부동,28259,13096,2.16,13929,14330,0.97
3271,4723052000,경상북도영천시중앙동,9688,4628,2.09,4855,4833,1.0
3272,4723053500,경상북도영천시서부동,4669,2732,1.71,2328,2341,0.99
3273,4723054000,경상북도영천시완산동,9530,4354,2.19,4702,4828,0.97
3274,4723055500,경상북도영천시남부동,4114,2396,1.72,2224,1890,1.18
3275,4725000000,경상북도상주시,95566,48965,1.95,46869,48697,0.96
3276,4725025000,경상북도상주시함창읍,6354,3392,1.87,3064,3290,0.93
3277,4725031000,경상북도상주시중동면,1381,785,1.76,674,707,0.95
3278,4725032500,경상북도상주시사벌국면,3798,2072,1.83,1859,1939,0.96
3279,4725033000,경상북도상주시낙동면,2968,1657,1.79,1446,1522,0.95
3280,4725033500,경상북도상주시낙동면동부출장소,965,562,1.72,476,489,0.97
3281,4725034000,경상북도상주시청리면,2563,1409,1.82,1247,1316,0.95
3282,4725035000,경상북도상주시공성면,3905,2141,1.82,1928,1977,0.98
3283,4725036000,경상북도상주시외남면,1620,880,1.84,802,818,0.98
3284,4725037000,경상북도상주시내서면,1895,1062,1.78,968,927,1.04
3285,4725038000,경상북도상주시모동면,2542,1328,1.91,1281,1261,1.02
3286,4725039000,경상북도상주시모서면,1712,959,1.79,872,840,1.04
3287,4725039500,경상북도상주시모서면서부출장소,749,426,1.76,359,390,0.92
3288,4725040000,경상북도상주시화동면,1940,1071,1.81,974,966,1.01
3289,4725041000,경상북도상주시화서면,2799,1489,1.88,1361,1438,0.95
3290,4725042000,경상북도상주시화북면,1204,671,1.79,603,601,1.0
3291,4725042600,경상북도상주시화북면서부출장소,316,203,1.56,168,148,1.14
3292,4725043000,경상북도상주시외서면,2651,1475,1.8,1262,1389,0.91
3293,4725044000,경상북도상주시은척면,1136,669,1.7,527,609,0.87
3294,4725044500,경상북도상주시은척면북부출장소,378,224,1.69,196,182,1.08
3295,4725045000,경상북도상주시공검면,2111,1200,1.76,1005,1106,0.91
3296,4725046000,경상북도상주시이안면,1987,1154,1.72,970,1017,0.95
3297,4725047000,경상북도상주시화남면,793,486,1.63,381,412,0.92
3298,4725052000,경상북도상주시남원동,11684,5368,2.18,5714,5970,0.96
3299,4725053000,경상북도상주시북문동,9342,4427,2.11,4694,4648,1.01
3300,4725054000,경상북도상주시계림동,8771,4273,2.05,4181,4590,0.91
3301,4725055000,경상북도상주시동문동,7865,3791,2.07,3826,4039,0.95
3302,4725056000,경상북도상주시동성동,3483,1732,2.01,1699,1784,0.95
3303,4725057000,경상북도상주시신흥동,8654,4059,2.13,4332,4322,1.0
3304,4728000000,경상북도문경시,71154,37069,1.92,34919,36235,0.96
3305,4728025000,경상북도문경시문경읍,5775,3188,1.81,2791,2984,0.94
3306,4728025100,경상북도문경시문경읍갈평출장소,1109,581,1.91,571,538,1.06
3307,4728025300,경상북도문경시가은읍,3206,1858,1.73,1564,1642,0.95
3308,4728025400,경상북도문경시가은읍북부출장소,883,536,1.65,473,410,1.15
3309,4728031000,경상북도문경시영순면,2452,1495,1.64,1289,1163,1.11
3310,4728032000,경상북도문경시산양면,3072,1743,1.76,1547,1525,1.01
3311,4728033000,경상북도문경시호계면,2434,1497,1.63,1178,1256,0.94
3312,4728034000,경상북도문경시산북면,2787,1649,1.69,1387,1400,0.99
3313,4728035000,경상북도문경시동로면,2008,1171,1.71,1027,981,1.05
3314,4728036000,경상북도문경시마성면,3558,2147,1.66,1692,1866,0.91
3315,4728037000,경상북도문경시농암면,2612,1595,1.64,1202,1410,0.85
3316,4728057000,경상북도문경시점촌1동,5742,2828,2.03,2798,2944,0.95
3317,4728058000,경상북도문경시점촌2동,7030,3648,1.93,3396,3634,0.93
3318,4728059000,경상북도문경시점촌3동,9060,4346,2.08,4499,4561,0.99
3319,4728060000,경상북도문경시점촌4동,3164,1792,1.77,1591,1573,1.01
3320,4728061000,경상북도문경시점촌5동,16262,6995,2.32,7914,8348,0.95
3321,4729000000,경상북도경산시,268369,124869,2.15,134940,133429,1.01
3322,4729025000,경상북도경산시하양읍,28053,12757,2.2,14118,13935,1.01
3323,4729025300,경상북도경산시진량읍,35568,17042,2.09,18565,17003,1.09
3324,4729025600,경상북도경산시압량읍,20797,10506,1.98,11063,9734,1.14
3325,4729031000,경상북도경산시와촌면,5732,3004,1.91,3080,2652,1.16
3326,4729033000,경상북도경산시자인면,5453,2936,1.86,2786,2667,1.04
3327,4729034000,경상북도경산시용성면,3270,1825,1.79,1715,1555,1.1
3328,4729035000,경상북도경산시남산면,3711,1950,1.9,1930,1781,1.08
3329,4729037000,경상북도경산시남천면,2919,1541,1.89,1502,1417,1.06
3330,4729051000,경상북도경산시중방동,9643,4738,2.04,4662,4981,0.94
3331,4729052000,경상북도경산시중앙동,6359,3520,1.81,3160,3199,0.99
3332,4729053000,경상북도경산시남부동,19968,8522,2.34,9836,10132,0.97
3333,4729054100,경상북도경산시서부1동,35561,15329,2.32,16889,18672,0.9
3334,4729054200,경상북도경산시서부2동,36165,14033,2.58,17344,18821,0.92
3335,4729055000,경상북도경산시북부동,16296,9766,1.67,8894,7402,1.2
3336,4729056000,경상북도경산시동부동,38874,17400,2.23,19396,19478,1.0
3337,4772000000,경상북도군위군,22945,13258,1.73,11761,11184,1.05
3338,4772025000,경상북도군위군군위읍,8161,4292,1.9,4223,3938,1.07
3339,4772031000,경상북도군위군소보면,2253,1410,1.6,1175,1078,1.09
3340,4772032000,경상북도군위군효령면,3753,2154,1.74,1937,1816,1.07
3341,4772033000,경상북도군위군부계면,2011,1184,1.7,1041,970,1.07
3342,4772034000,경상북도군위군우보면,1933,1210,1.6,968,965,1.0
3343,4772035000,경상북도군위군의흥면,2356,1416,1.66,1143,1213,0.94
3344,4772036000,경상북도군위군산성면,1182,748,1.58,598,584,1.02
3345,4772038000,경상북도군위군삼국유사면,1296,844,1.54,676,620,1.09
3346,4773000000,경상북도의성군,50632,28798,1.76,24796,25836,0.96
3347,4773025000,경상북도의성군의성읍,12971,6673,1.94,6342,6629,0.96
3348,4773031000,경상북도의성군단촌면,1924,1163,1.65,955,969,0.99
3349,4773032000,경상북도의성군점곡면,1614,988,1.63,793,821,0.97
3350,4773033000,경상북도의성군옥산면,1745,999,1.75,868,877,0.99
3351,4773034000,경상북도의성군사곡면,1551,956,1.62,752,799,0.94
3352,4773035000,경상북도의성군춘산면,1450,806,1.8,741,709,1.05
3353,4773036000,경상북도의성군가음면,1456,859,1.69,728,728,1.0
3354,4773037000,경상북도의성군금성면,4201,2491,1.69,2053,2148,0.96
3355,4773038000,경상북도의성군봉양면,3842,2259,1.7,1872,1970,0.95
3356,4773039000,경상북도의성군비안면,2573,1537,1.67,1259,1314,0.96
3357,4773040000,경상북도의성군구천면,1756,1004,1.75,879,877,1.0
3358,4773041000,경상북도의성군단밀면,1698,977,1.74,849,849,1.0
3359,4773042000,경상북도의성군단북면,1783,1028,1.73,857,926,0.93
3360,4773043000,경상북도의성군안계면,4543,2525,1.8,2165,2378,0.91
3361,4773044000,경상북도의성군다인면,3765,2202,1.71,1831,1934,0.95
3362,4773045000,경상북도의성군신평면,822,514,1.6,394,428,0.92
3363,4773046000,경상북도의성군안평면,2126,1275,1.67,1068,1058,1.01
3364,4773047000,경상북도의성군안사면,812,542,1.5,390,422,0.92
3365,4775000000,경상북도청송군,24539,14029,1.75,12261,12278,1.0
3366,4775025000,경상북도청송군청송읍,5108,2665,1.92,2516,2592,0.97
3367,4775031500,경상북도청송군주왕산면,1808,1086,1.66,906,902,1.0
3368,4775032000,경상북도청송군부남면,2461,1429,1.72,1220,1241,0.98
3369,4775033000,경상북도청송군현동면,2091,1189,1.76,1046,1045,1.0
3370,4775034000,경상북도청송군현서면,2494,1435,1.74,1238,1256,0.99
3371,4775035000,경상북도청송군안덕면,2574,1576,1.63,1246,1328,0.94
3372,4775036000,경상북도청송군파천면,1741,1050,1.66,878,863,1.02
3373,4775037000,경상북도청송군진보면,6262,3599,1.74,3211,3051,1.05
3374,4776000000,경상북도영양군,16320,9055,1.8,8144,8176,1.0
3375,4776025000,경상북도영양군영양읍,7125,3713,1.92,3546,3579,0.99
3376,4776031000,경상북도영양군입암면,2085,1210,1.72,1006,1079,0.93
3377,4776032000,경상북도영양군청기면,1692,1011,1.67,860,832,1.03
3378,4776033000,경상북도영양군일월면,1764,991,1.78,873,891,0.98
3379,4776034000,경상북도영양군수비면,1663,954,1.74,844,819,1.03
3380,4776035000,경상북도영양군석보면,1991,1176,1.69,1015,976,1.04
3381,4777000000,경상북도영덕군,35314,19895,1.78,16777,18537,0.91
3382,4777025000,경상북도영덕군영덕읍,10740,5457,1.97,5160,5580,0.92
3383,4777031000,경상북도영덕군강구면,6000,3431,1.75,2825,3175,0.89
3384,4777032000,경상북도영덕군남정면,2327,1458,1.6,1130,1197,0.94
3385,4777033000,경상북도영덕군달산면,1113,714,1.56,504,609,0.83
3386,4777034000,경상북도영덕군지품면,1477,883,1.67,728,749,0.97
3387,4777034500,경상북도영덕군지품면원전출장소,522,309,1.69,247,275,0.9
3388,4777035000,경상북도영덕군축산면,904,534,1.69,427,477,0.9
3389,4777035500,경상북도영덕군축산면축산출장소,1651,986,1.67,767,884,0.87
3390,4777036000,경상북도영덕군영해면,6212,3406,1.82,2899,3313,0.88
3391,4777037000,경상북도영덕군병곡면,2734,1677,1.63,1291,1443,0.89
3392,4777038000,경상북도영덕군창수면,1634,1040,1.57,799,835,0.96
3393,4782000000,경상북도청도군,41891,23251,1.8,20598,21293,0.97
3394,4782025000,경상북도청도군화양읍,7213,3452,2.09,3530,3683,0.96
3395,4782025100,경상북도청도군화양읍남성현출장소,1120,647,1.73,564,556,1.01
3396,4782025300,경상북도청도군청도읍,10145,5197,1.95,4961,5184,0.96
3397,4782025400,경상북도청도군청도읍유호출장소,1575,926,1.7,762,813,0.94
3398,4782031000,경상북도청도군각남면,2159,1288,1.68,1028,1131,0.91
3399,4782032000,경상북도청도군풍각면,3858,2274,1.7,1894,1964,0.96
3400,4782033000,경상북도청도군각북면,2238,1366,1.64,1103,1135,0.97
3401,4782034000,경상북도청도군이서면,4513,2518,1.79,2199,2314,0.95
3402,4782035000,경상북도청도군운문면,2061,1293,1.59,1026,1035,0.99
3403,4782036000,경상북도청도군금천면,3273,2004,1.63,1659,1614,1.03
3404,4782037000,경상북도청도군매전면,3736,2286,1.63,1872,1864,1.0
3405,4783000000,경상북도고령군,30626,16556,1.85,15741,14885,1.06
3406,4783025300,경상북도고령군대가야읍,9886,5019,1.97,4988,4898,1.02
3407,4783031000,경상북도고령군덕곡면,1414,850,1.66,711,703,1.01
3408,4783032000,경상북도고령군운수면,1812,1101,1.65,918,894,1.03
3409,4783033000,경상북도고령군성산면,2515,1450,1.73,1372,1143,1.2
3410,4783034000,경상북도고령군다산면,8295,4138,2.0,4308,3987,1.08
3411,4783035000,경상북도고령군개진면,1902,1214,1.57,1026,876,1.17
3412,4783036000,경상북도고령군우곡면,1548,892,1.74,799,749,1.07
3413,4783037000,경상북도고령군쌍림면,3254,1892,1.72,1619,1635,0.99
3414,4784000000,경상북도성주군,42842,23621,1.81,22216,20626,1.08
3415,4784025000,경상북도성주군성주읍,13518,6672,2.03,6856,6662,1.03
3416,4784031000,경상북도성주군선남면,6110,3485,1.75,3337,2773,1.2
3417,4784032000,경상북도성주군용암면,3638,2163,1.68,1998,1640,1.22
3418,4784033000,경상북도성주군수륜면,3143,1940,1.62,1568,1575,1.0
3419,4784034000,경상북도성주군가천면,2003,1224,1.64,1000,1003,1.0
3420,4784035000,경상북도성주군금수면,1196,772,1.55,627,569,1.1
3421,4784036000,경상북도성주군대가면,2427,1372,1.77,1230,1197,1.03
3422,4784037000,경상북도성주군벽진면,3041,1698,1.79,1571,1470,1.07
3423,4784038000,경상북도성주군초전면,4439,2437,1.82,2261,2178,1.04
3424,4784039000,경상북도성주군월항면,3327,1858,1.79,1768,1559,1.13
3425,4785000000,경상북도칠곡군,113822,53883,2.11,59260,54562,1.09
3426,4785025000,경상북도칠곡군왜관읍,32755,15023,2.18,16404,16351,1.0
3427,4785025300,경상북도칠곡군북삼읍,24383,10587,2.3,12651,11732,1.08
3428,4785025600,경상북도칠곡군석적읍,31178,14471,2.15,16866,14312,1.18
3429,4785031000,경상북도칠곡군지천면,4096,2401,1.71,2193,1903,1.15
3430,4785032000,경상북도칠곡군동명면,5335,2965,1.8,2719,2616,1.04
3431,4785033000,경상북도칠곡군가산면,3428,1993,1.72,1861,1567,1.19
3432,4785036000,경상북도칠곡군약목면,9523,4807,1.98,4934,4589,1.08
3433,4785037000,경상북도칠곡군기산면,3124,1636,1.91,1632,1492,1.09
3434,4790000000,경상북도예천군,55739,27771,2.01,27391,28348,0.97
3435,4790025000,경상북도예천군예천읍,14548,7362,1.98,7169,7379,0.97
3436,4790031000,경상북도예천군용문면,2268,1347,1.68,1137,1131,1.01
3437,4790034000,경상북도예천군감천면,2604,1492,1.75,1295,1309,0.99
3438,4790035000,경상북도예천군보문면,1672,963,1.74,827,845,0.98
3439,4790036000,경상북도예천군호명면,19948,7961,2.51,9762,10186,0.96
3440,4790037000,경상북도예천군유천면,2535,1448,1.75,1263,1272,0.99
3441,4790038000,경상북도예천군용궁면,2379,1383,1.72,1160,1219,0.95
3442,4790039000,경상북도예천군개포면,1494,921,1.62,724,770,0.94
3443,4790040000,경상북도예천군지보면,2683,1603,1.67,1319,1364,0.97
3444,4790041000,경상북도예천군풍양면,3078,1847,1.67,1475,1603,0.92
3445,4790042000,경상북도예천군효자면,1160,692,1.68,581,579,1.0
3446,4790043000,경상북도예천군은풍면,1370,752,1.82,679,691,0.98
3447,4792000000,경상북도봉화군,30762,16882,1.82,15551,15211,1.02
3448,4792025000,경상북도봉화군봉화읍,9701,4796,2.02,4798,4903,0.98
3449,4792031000,경상북도봉화군물야면,3059,1750,1.75,1547,1512,1.02
3450,4792032000,경상북도봉화군봉성면,2077,1139,1.82,1005,1072,0.94
3451,4792033000,경상북도봉화군법전면,2001,1149,1.74,1013,988,1.03
3452,4792034000,경상북도봉화군춘양면,4350,2491,1.75,2175,2175,1.0
3453,4792035000,경상북도봉화군소천면,2179,1341,1.62,1098,1081,1.02
3454,4792036000,경상북도봉화군재산면,1496,873,1.71,758,738,1.03
3455,4792037000,경상북도봉화군명호면,2213,1259,1.76,1163,1050,1.11
3456,4792038000,경상북도봉화군상운면,1691,1010,1.67,867,824,1.05
3457,4792039000,경상북도봉화군석포면,1995,1074,1.86,1127,868,1.3
3458,4793000000,경상북도울진군,47858,25535,1.87,24026,23832,1.01
3459,4793025000,경상북도울진군울진읍,13878,6263,2.22,7018,6860,1.02
3460,4793025300,경상북도울진군평해읍,2721,1671,1.63,1297,1424,0.91
3461,4793031000,경상북도울진군북면,6681,3398,1.97,3534,3147,1.12
3462,4793031500,경상북도울진군북면하당출장소,679,396,1.71,351,328,1.07
3463,4793033000,경상북도울진군근남면,2740,1563,1.75,1383,1357,1.02
3464,4793035000,경상북도울진군기성면,2482,1601,1.55,1183,1299,0.91
3465,4793036000,경상북도울진군온정면,1693,1009,1.68,816,877,0.93
3466,4793037000,경상북도울진군죽변면,6287,3589,1.75,3244,3043,1.07
3467,4793038000,경상북도울진군후포면,7410,4014,1.85,3619,3791,0.95
3468,4793039000,경상북도울진군금강송면,1280,783,1.63,630,650,0.97
3469,4793040000,경상북도울진군매화면,2007,1248,1.61,951,1056,0.9
3470,4794000000,경상북도울릉군,8867,5258,1.69,4851,4016,1.21
3471,4794025000,경상북도울릉군울릉읍,6278,3699,1.7,3446,2832,1.22
3472,4794031000,경상북도울릉군서면,881,463,1.9,471,410,1.15
3473,4794031500,경상북도울릉군서면태하출장소,443,278,1.59,242,201,1.2
3474,4794032000,경상북도울릉군북면,1265,818,1.55,692,573,1.21
3475,4800000000,경상남도,3314183,1505971,2.2,1668338,1645845,1.01
3476,4812000000,경상남도창원시,1032741,451940,2.29,523223,509518,1.03
3477,4812100000,경상남도창원시의창구,218027,95630,2.28,110998,107029,1.04
3478,4812125000,경상남도창원시의창구동읍,19769,9069,2.18,10073,9696,1.04
3479,4812131000,경상남도창원시의창구북면,43422,16676,2.6,21851,21571,1.01
3480,4812132000,경상남도창원시의창구대산면,7118,3673,1.94,3600,3518,1.02
3481,4812151000,경상남도창원시의창구의창동,50348,21116,2.38,25495,24853,1.03
3482,4812152000,경상남도창원시의창구팔룡동,25927,11008,2.36,13254,12673,1.05
3483,4812153000,경상남도창원시의창구명곡동,41362,18171,2.28,21036,20326,1.03
3484,4812154000,경상남도창원시의창구봉림동,30081,15917,1.89,15689,14392,1.09
3485,4812300000,경상남도창원시성산구,251562,105052,2.39,128346,123216,1.04
3486,4812351000,경상남도창원시성산구반송동,41027,15461,2.65,20690,20337,1.02
3487,4812351500,경상남도창원시성산구용지동,29453,13296,2.22,14802,14651,1.01
3488,4812352000,경상남도창원시성산구중앙동,34507,17890,1.93,18611,15896,1.17
3489,4812353000,경상남도창원시성산구상남동,27699,10693,2.59,13906,13793,1.01
3490,4812354000,경상남도창원시성산구사파동,44616,18521,2.41,22186,22430,0.99
3491,4812355000,경상남도창원시성산구가음정동,40288,16000,2.52,20428,19860,1.03
3492,4812356000,경상남도창원시성산구성주동,26219,9719,2.7,13659,12560,1.09
3493,4812357000,경상남도창원시성산구웅남동,7753,3472,2.23,4064,3689,1.1
3494,4812500000,경상남도창원시마산합포구,181322,84087,2.16,90141,91181,0.99
3495,4812531000,경상남도창원시마산합포구구산면,4202,2322,1.81,2181,2021,1.08
3496,4812532000,경상남도창원시마산합포구진동면,12129,5528,2.19,6239,5890,1.06
3497,4812533000,경상남도창원시마산합포구진북면,3378,1757,1.92,1808,1570,1.15
3498,4812534000,경상남도창원시마산합포구진전면,3848,2180,1.77,1900,1948,0.98
3499,4812551000,경상남도창원시마산합포구현동,14124,5681,2.49,7007,7117,0.98
3500,4812552000,경상남도창원시마산합포구가포동,1543,942,1.64,793,750,1.06
3501,4812553000,경상남도창원시마산합포구월영동,42370,16851,2.51,21034,21336,0.99
3502,4812554000,경상남도창원시마산합포구문화동,10983,5767,1.9,5436,5547,0.98
3503,4812556500,경상남도창원시마산합포구반월중앙동,14460,6465,2.24,7030,7430,0.95
3504,4812557000,경상남도창원시마산합포구완월동,9001,4065,2.21,4350,4651,0.94
3505,4812558000,경상남도창원시마산합포구자산동,10286,4795,2.15,5058,5228,0.97
3506,4812561000,경상남도창원시마산합포구교방동,16106,7247,2.22,7988,8118,0.98
3507,4812563000,경상남도창원시마산합포구오동동,19334,10552,1.83,9550,9784,0.98
3508,4812564000,경상남도창원시마산합포구합포동,7328,3811,1.92,3707,3621,1.02
3509,4812565000,경상남도창원시마산합포구산호동,12230,6124,2.0,6060,6170,0.98
3510,4812700000,경상남도창원시마산회원구,186881,82405,2.27,93661,93220,1.0
3511,4812725000,경상남도창원시마산회원구내서읍,63446,25042,2.53,31908,31538,1.01
3512,4812751000,경상남도창원시마산회원구회원1동,10164,5170,1.97,5028,5136,0.98
3513,4812752000,경상남도창원시마산회원구회원2동,10064,4598,2.19,4975,5089,0.98
3514,4812754500,경상남도창원시마산회원구석전동,16791,7894,2.13,8387,8404,1.0
3515,4812755000,경상남도창원시마산회원구회성동,6037,3098,1.95,3069,2968,1.03
3516,4812756000,경상남도창원시마산회원구양덕1동,10970,5436,2.02,5501,5469,1.01
3517,4812757000,경상남도창원시마산회원구양덕2동,31215,11884,2.63,15398,15817,0.97
3518,4812758000,경상남도창원시마산회원구합성1동,9297,4553,2.04,4725,4572,1.03
3519,4812759000,경상남도창원시마산회원구합성2동,7489,4193,1.79,3755,3734,1.01
3520,4812760000,경상남도창원시마산회원구구암1동,8860,4315,2.05,4447,4413,1.01
3521,4812761000,경상남도창원시마산회원구구암2동,9329,4374,2.13,4664,4665,1.0
3522,4812762000,경상남도창원시마산회원구봉암동,3219,1848,1.74,1804,1415,1.27
3523,4812900000,경상남도창원시진해구,194949,84766,2.3,100077,94872,1.05
3524,4812953000,경상남도창원시진해구충무동,16962,7793,2.18,8811,8151,1.08
3525,4812954000,경상남도창원시진해구여좌동,8469,4362,1.94,4183,4286,0.98
3526,4812955000,경상남도창원시진해구태백동,4130,2188,1.89,2079,2051,1.01
3527,4812956000,경상남도창원시진해구경화동,11097,4624,2.4,5621,5476,1.03
3528,4812957000,경상남도창원시진해구병암동,7431,3403,2.18,3666,3765,0.97
3529,4812958000,경상남도창원시진해구석동,17555,7136,2.46,9013,8542,1.06
3530,4812959000,경상남도창원시진해구이동,8583,4729,1.81,4541,4042,1.12
3531,4812960000,경상남도창원시진해구자은동,21235,8849,2.4,10590,10645,0.99
3532,4812961000,경상남도창원시진해구덕산동,10154,4204,2.42,5004,5150,0.97
3533,4812962000,경상남도창원시진해구풍호동,25699,9136,2.81,12858,12841,1.0
3534,4812963000,경상남도창원시진해구웅천동,12985,5398,2.41,6594,6391,1.03
3535,4812964000,경상남도창원시진해구웅동1동,6975,3113,2.24,3583,3392,1.06
3536,4812965000,경상남도창원시진해구웅동2동,43674,19831,2.2,23534,20140,1.17
3537,4817000000,경상남도진주시,347097,157292,2.21,171601,175496,0.98
3538,4817025000,경상남도진주시문산읍,8059,3650,2.21,4083,3976,1.03
3539,4817031000,경상남도진주시내동면,4020,1634,2.46,2019,2001,1.01
3540,4817032000,경상남도진주시정촌면,8772,4031,2.18,4480,4292,1.04
3541,4817033000,경상남도진주시금곡면,2184,1235,1.77,1039,1145,0.91
3542,4817035000,경상남도진주시진성면,1872,1078,1.74,924,948,0.97
3543,4817036000,경상남도진주시일반성면,2557,1362,1.88,1249,1308,0.95
3544,4817037000,경상남도진주시이반성면,1581,1013,1.56,795,786,1.01
3545,4817038000,경상남도진주시사봉면,1478,888,1.66,725,753,0.96
3546,4817039000,경상남도진주시지수면,1430,827,1.73,714,716,1.0
3547,4817040000,경상남도진주시대곡면,3188,1813,1.76,1594,1594,1.0
3548,4817041000,경상남도진주시금산면,20903,7911,2.64,10479,10424,1.01
3549,4817042000,경상남도진주시집현면,4638,2162,2.15,2314,2324,1.0
3550,4817043000,경상남도진주시미천면,1579,936,1.69,779,800,0.97
3551,4817044000,경상남도진주시명석면,3982,2149,1.85,1958,2024,0.97
3552,4817045000,경상남도진주시대평면,1036,568,1.82,497,539,0.92
3553,4817046000,경상남도진주시수곡면,2185,1236,1.77,1066,1119,0.95
3554,4817051500,경상남도진주시천전동,27872,13374,2.08,13690,14182,0.97
3555,4817055500,경상남도진주시성북동,10300,5956,1.73,5087,5213,0.98
3556,4817056500,경상남도진주시중앙동,11014,6270,1.76,5323,5691,0.94
3557,4817059500,경상남도진주시상봉동,13823,7312,1.89,6822,7001,0.97
3558,4817067300,경상남도진주시상대동,19311,9877,1.96,9557,9754,0.98
3559,4817067800,경상남도진주시하대동,24152,11055,2.18,12079,12073,1.0
3560,4817068000,경상남도진주시상평동,11492,5498,2.09,5835,5657,1.03
3561,4817069500,경상남도진주시초장동,26841,9459,2.84,13572,13269,1.02
3562,4817071000,경상남도진주시평거동,27373,11338,2.41,13086,14287,0.92
3563,4817071500,경상남도진주시신안동,11602,5312,2.18,5483,6119,0.9
3564,4817072000,경상남도진주시이현동,11875,5236,2.27,5851,6024,0.97
3565,4817073000,경상남도진주시판문동,21005,7959,2.64,9999,11006,0.91
3566,4817074000,경상남도진주시가호동,27983,13855,2.02,14188,13795,1.03
3567,4817075000,경상남도진주시충무공동,32990,12298,2.68,16314,16676,0.98
3568,4822000000,경상남도통영시,125383,59738,2.1,62928,62455,1.01
3569,4822025000,경상남도통영시산양읍,4558,2584,1.76,2398,2160,1.11
3570,4822031000,경상남도통영시용남면,12382,5182,2.39,6197,6185,1.0
3571,4822033000,경상남도통영시도산면,2839,1588,1.79,1458,1381,1.06
3572,4822034000,경상남도통영시광도면,30965,13088,2.37,15656,15309,1.02
3573,4822035000,경상남도통영시욕지면,1974,1257,1.57,1103,871,1.27
3574,4822036000,경상남도통영시한산면,1951,1269,1.54,1008,943,1.07
3575,4822037000,경상남도통영시사량면,1443,944,1.53,711,732,0.97
3576,4822051000,경상남도통영시도천동,8670,4394,1.97,4308,4362,0.99
3577,4822053000,경상남도통영시명정동,2840,1595,1.78,1392,1448,0.96
3578,4822055000,경상남도통영시중앙동,3854,2178,1.77,1920,1934,0.99
3579,4822059000,경상남도통영시정량동,8743,4449,1.97,4432,4311,1.03
3580,4822060000,경상남도통영시북신동,10364,4704,2.2,4963,5401,0.92
3581,4822066500,경상남도통영시미수동,11048,4854,2.28,5414,5634,0.96
3582,4822067000,경상남도통영시봉평동,10093,5377,1.88,5173,4920,1.05
3583,4822070000,경상남도통영시무전동,13659,6275,2.18,6795,6864,0.99
3584,4824000000,경상남도사천시,109953,53944,2.04,55433,54520,1.02
3585,4824025000,경상남도사천시사천읍,17716,8700,2.04,9259,8457,1.09
3586,4824031000,경상남도사천시정동면,13724,5960,2.3,6889,6835,1.01
3587,4824032000,경상남도사천시사남면,15306,6564,2.33,7973,7333,1.09
3588,4824033000,경상남도사천시용현면,7376,3703,1.99,3682,3694,1.0
3589,4824034000,경상남도사천시축동면,1552,895,1.73,802,750,1.07
3590,4824035000,경상남도사천시곤양면,3348,1966,1.7,1717,1631,1.05
3591,4824036000,경상남도사천시곤명면,2768,1678,1.65,1388,1380,1.01
3592,4824037000,경상남도사천시서포면,3451,1952,1.77,1686,1765,0.96
3593,4824051000,경상남도사천시동서동,5864,3244,1.81,2871,2993,0.96
3594,4824052000,경상남도사천시선구동,4875,2641,1.85,2406,2469,0.97
3595,4824053000,경상남도사천시동서금동,6283,3170,1.98,3056,3227,0.95
3596,4824055000,경상남도사천시벌용동,15619,7453,2.1,7582,8037,0.94
3597,4824057000,경상남도사천시향촌동,6713,3319,2.02,3485,3228,1.08
3598,4824059500,경상남도사천시남양동,5107,2551,2.0,2510,2597,0.97
3599,4824089000,경상남도사천시신수출장소,251,148,1.7,127,124,1.02
3600,4824500000,경상남도사천남양출장소,0,0,0.0,0,0,0.0
3601,4825000000,경상남도김해시,537673,225984,2.38,271899,265774,1.02
3602,4825025000,경상남도김해시진영읍,55638,24039,2.31,28651,26987,1.06
3603,4825032000,경상남도김해시주촌면,18709,7357,2.54,9585,9124,1.05
3604,4825033000,경상남도김해시진례면,6383,3540,1.8,3498,2885,1.21
3605,4825034000,경상남도김해시한림면,7291,4088,1.78,3980,3311,1.2
3606,4825035000,경상남도김해시생림면,3825,2220,1.72,2038,1787,1.14
3607,4825036000,경상남도김해시상동면,3138,1690,1.86,1732,1406,1.23
3608,4825037000,경상남도김해시대동면,5614,2978,1.89,2913,2701,1.08
3609,4825051000,경상남도김해시동상동,9650,4773,2.02,4933,4717,1.05
3610,4825052000,경상남도김해시회현동,8977,4324,2.08,4480,4497,1.0
3611,4825053000,경상남도김해시부원동,9829,4886,2.01,5015,4814,1.04
3612,4825054000,경상남도김해시내외동,73113,31917,2.29,36435,36678,0.99
3613,4825055000,경상남도김해시북부동,79915,30947,2.58,40005,39910,1.0
3614,4825056500,경상남도김해시칠산서부동,9519,4452,2.14,5060,4459,1.13
3615,4825058000,경상남도김해시활천동,39955,17544,2.28,20327,19628,1.04
3616,4825059000,경상남도김해시삼안동,32548,15308,2.13,16638,15910,1.05
3617,4825060000,경상남도김해시불암동,7521,3124,2.41,3838,3683,1.04
3618,4825061000,경상남도김해시장유1동,56720,21825,2.6,28237,28483,0.99
3619,4825062000,경상남도김해시장유2동,36269,14404,2.52,18284,17985,1.02
3620,4825063000,경상남도김해시장유3동,73059,26568,2.75,36250,36809,0.98
3621,4825200000,경상남도장유출장소,0,0,0.0,0,0,0.0
3622,4827000000,경상남도밀양시,103525,53120,1.95,50849,52676,0.97
3623,4827025000,경상남도밀양시삼랑진읍,5238,2876,1.82,2615,2623,1.0
3624,4827025100,경상남도밀양시삼랑진임천출장소,1261,747,1.69,630,631,1.0
3625,4827025300,경상남도밀양시하남읍,7042,3819,1.84,3528,3514,1.0
3626,4827031000,경상남도밀양시부북면,5076,2858,1.78,2633,2443,1.08
3627,4827032000,경상남도밀양시상동면,3039,1869,1.63,1459,1580,0.92
3628,4827033000,경상남도밀양시산외면,2799,1612,1.74,1429,1370,1.04
3629,4827034000,경상남도밀양시산내면,3807,2138,1.78,1940,1867,1.04
3630,4827035000,경상남도밀양시단장면,4272,2531,1.69,2121,2151,0.99
3631,4827036000,경상남도밀양시상남면,8262,4151,1.99,4123,4139,1.0
3632,4827037000,경상남도밀양시초동면,3365,1983,1.7,1661,1704,0.97
3633,4827038000,경상남도밀양시무안면,4897,2809,1.74,2390,2507,0.95
3634,4827039000,경상남도밀양시청도면,1768,1098,1.61,850,918,0.93
3635,4827051000,경상남도밀양시내일동,2612,1446,1.81,1263,1349,0.94
3636,4827052000,경상남도밀양시내이동,16341,8021,2.04,8097,8244,0.98
3637,4827053000,경상남도밀양시삼문동,20120,8259,2.44,9658,10462,0.92
3638,4827054000,경상남도밀양시가곡동,7809,4144,1.88,3634,4175,0.87
3639,4827055000,경상남도밀양시교동,5817,2759,2.11,2818,2999,0.94
3640,4831000000,경상남도거제시,241216,103674,2.33,126291,114925,1.1
3641,4831031000,경상남도거제시일운면,8132,3990,2.04,4159,3973,1.05
3642,4831032000,경상남도거제시동부면,3076,1660,1.85,1592,1484,1.07
3643,4831033000,경상남도거제시남부면,1562,916,1.71,794,768,1.03
3644,4831034000,경상남도거제시거제면,7272,3431,2.12,3597,3675,0.98
3645,4831035000,경상남도거제시둔덕면,2845,1520,1.87,1472,1373,1.07
3646,4831036000,경상남도거제시사등면,11828,5140,2.3,6144,5684,1.08
3647,4831036600,경상남도거제시사등면가조출장소,1086,590,1.84,553,533,1.04
3648,4831037000,경상남도거제시연초면,8046,4127,1.95,4454,3592,1.24
3649,4831038000,경상남도거제시하청면,3490,1788,1.95,1806,1684,1.07
3650,4831038500,경상남도거제시하청면칠천출장소,1056,629,1.68,535,521,1.03
3651,4831039000,경상남도거제시장목면,3098,1728,1.79,1582,1516,1.04
3652,4831039500,경상남도거제시장목면외포출장소,1374,751,1.83,684,690,0.99
3653,4831051000,경상남도거제시장승포동,5865,2933,2.0,3222,2643,1.22
3654,4831053000,경상남도거제시능포동,9172,4128,2.22,4960,4212,1.18
3655,4831054000,경상남도거제시아주동,26932,10325,2.61,14402,12530,1.15
3656,4831055000,경상남도거제시옥포1동,7259,3640,1.99,3921,3338,1.17
3657,4831056000,경상남도거제시옥포2동,25842,11183,2.31,13442,12400,1.08
3658,4831057000,경상남도거제시장평동,20753,9956,2.08,11762,8991,1.31
3659,4831058000,경상남도거제시고현동,34323,15013,2.29,17650,16673,1.06
3660,4831059000,경상남도거제시상문동,34418,12004,2.87,17445,16973,1.03
3661,4831060000,경상남도거제시수양동,23787,8222,2.89,12115,11672,1.04
3662,4833000000,경상남도양산시,354726,153732,2.31,177759,176967,1.0
3663,4833025300,경상남도양산시물금읍,120539,48191,2.5,59540,60999,0.98
3664,4833031000,경상남도양산시동면,37480,15463,2.42,19026,18454,1.03
3665,4833032000,경상남도양산시원동면,3362,2021,1.66,1728,1634,1.06
3666,4833033000,경상남도양산시상북면,12647,6385,1.98,6460,6187,1.04
3667,4833034000,경상남도양산시하북면,8018,4265,1.88,4178,3840,1.09
3668,4833051000,경상남도양산시중앙동,11414,6561,1.74,6049,5365,1.13
3669,4833051500,경상남도양산시양주동,32841,12870,2.55,15852,16989,0.93
3670,4833052000,경상남도양산시삼성동,21856,10616,2.06,11485,10371,1.11
3671,4833053000,경상남도양산시강서동,8927,3852,2.32,4481,4446,1.01
3672,4833054000,경상남도양산시서창동,28406,12911,2.2,14834,13572,1.09
3673,4833055000,경상남도양산시소주동,20375,9656,2.11,10190,10185,1.0
3674,4833056000,경상남도양산시평산동,30670,13315,2.3,14949,15721,0.95
3675,4833057000,경상남도양산시덕계동,18191,7626,2.39,8987,9204,0.98
3676,4833200000,경상남도양산시웅상출장소,0,0,0.0,0,0,0.0
3677,4872000000,경상남도의령군,26322,15010,1.75,12966,13356,0.97
3678,4872025000,경상남도의령군의령읍,9458,4714,2.01,4681,4777,0.98
3679,4872031000,경상남도의령군가례면,1676,877,1.91,833,843,0.99
3680,4872032000,경상남도의령군칠곡면,1158,693,1.67,573,585,0.98
3681,4872033000,경상남도의령군대의면,1025,658,1.56,496,529,0.94
3682,4872034000,경상남도의령군화정면,1509,891,1.69,747,762,0.98
3683,4872035000,경상남도의령군용덕면,1515,894,1.69,758,757,1.0
3684,4872036000,경상남도의령군정곡면,1424,879,1.62,691,733,0.94
3685,4872037000,경상남도의령군지정면,1804,1120,1.61,919,885,1.04
3686,4872038000,경상남도의령군낙서면,740,459,1.61,347,393,0.88
3687,4872039000,경상남도의령군부림면,2767,1670,1.66,1334,1433,0.93
3688,4872040000,경상남도의령군봉수면,985,649,1.52,518,467,1.11
3689,4872041500,경상남도의령군궁류면,1119,769,1.46,521,598,0.87
3690,4872042000,경상남도의령군유곡면,1142,737,1.55,548,594,0.92
3691,4873000000,경상남도함안군,62547,30978,2.02,31816,30731,1.04
3692,4873025000,경상남도함안군가야읍,18163,8365,2.17,9146,9017,1.01
3693,4873025300,경상남도함안군칠원읍,19042,7919,2.4,9658,9384,1.03
3694,4873031000,경상남도함안군함안면,2389,1376,1.74,1209,1180,1.02
3695,4873032000,경상남도함안군군북면,6064,3547,1.71,3162,2902,1.09
3696,4873033000,경상남도함안군법수면,2806,1723,1.63,1440,1366,1.05
3697,4873034000,경상남도함안군대산면,3345,2049,1.63,1670,1675,1.0
3698,4873035000,경상남도함안군칠서면,5260,2840,1.85,2752,2508,1.1
3699,4873036000,경상남도함안군칠북면,1896,1139,1.66,975,921,1.06
3700,4873038000,경상남도함안군산인면,2681,1487,1.8,1343,1338,1.0
3701,4873039000,경상남도함안군여항면,901,533,1.69,461,440,1.05
3702,4874000000,경상남도창녕군,60129,32469,1.85,29948,30181,0.99
3703,4874025000,경상남도창녕군창녕읍,16694,7994,2.09,8279,8415,0.98
3704,4874025300,경상남도창녕군남지읍,11965,6081,1.97,6016,5949,1.01
3705,4874031000,경상남도창녕군고암면,1923,1126,1.71,954,969,0.98
3706,4874032000,경상남도창녕군성산면,1603,1013,1.58,752,851,0.88
3707,4874033000,경상남도창녕군대합면,3857,2350,1.64,1993,1864,1.07
3708,4874034000,경상남도창녕군이방면,2480,1499,1.65,1158,1322,0.88
3709,4874035000,경상남도창녕군유어면,1754,1095,1.6,860,894,0.96
3710,4874036000,경상남도창녕군대지면,2528,1378,1.83,1309,1219,1.07
3711,4874037000,경상남도창녕군계성면,2342,1413,1.66,1183,1159,1.02
3712,4874038000,경상남도창녕군영산면,5383,2879,1.87,2711,2672,1.01
3713,4874039000,경상남도창녕군장마면,1843,1112,1.66,908,935,0.97
3714,4874040000,경상남도창녕군도천면,2725,1558,1.75,1344,1381,0.97
3715,4874041000,경상남도창녕군길곡면,1501,887,1.69,754,747,1.01
3716,4874042000,경상남도창녕군부곡면,3531,2084,1.69,1727,1804,0.96
3717,4882000000,경상남도고성군,50478,26318,1.92,25297,25181,1.0
3718,4882025000,경상남도고성군고성읍,23986,11339,2.12,12022,11964,1.0
3719,4882031000,경상남도고성군삼산면,1769,1029,1.72,911,858,1.06
3720,4882032000,경상남도고성군하일면,1821,1042,1.75,887,934,0.95
3721,4882033000,경상남도고성군하이면,2671,1377,1.94,1367,1304,1.05
3722,4882034000,경상남도고성군상리면,1590,922,1.72,791,799,0.99
3723,4882035000,경상남도고성군대가면,1638,982,1.67,834,804,1.04
3724,4882036000,경상남도고성군영현면,861,538,1.6,389,472,0.82
3725,4882037000,경상남도고성군영오면,1411,806,1.75,691,720,0.96
3726,4882038000,경상남도고성군개천면,1094,644,1.7,540,554,0.97
3727,4882039000,경상남도고성군구만면,1022,614,1.66,516,506,1.02
3728,4882040000,경상남도고성군회화면,3534,1935,1.83,1719,1815,0.95
3729,4882041000,경상남도고성군마암면,1723,944,1.83,857,866,0.99
3730,4882042000,경상남도고성군동해면,3052,1761,1.73,1573,1479,1.06
3731,4882043000,경상남도고성군거류면,4306,2385,1.81,2200,2106,1.04
3732,4884000000,경상남도남해군,42266,22786,1.85,20450,21816,0.94
3733,4884025000,경상남도남해군남해읍,13087,6276,2.09,6404,6683,0.96
3734,4884031000,경상남도남해군이동면,3643,2007,1.82,1754,1889,0.93
3735,4884032000,경상남도남해군상주면,1627,923,1.76,800,827,0.97
3736,4884033000,경상남도남해군삼동면,3873,2217,1.75,1885,1988,0.95
3737,4884034000,경상남도남해군미조면,2261,1222,1.85,1165,1096,1.06
3738,4884035000,경상남도남해군남면,3440,2094,1.64,1660,1780,0.93
3739,4884036000,경상남도남해군서면,2572,1488,1.73,1234,1338,0.92
3740,4884037000,경상남도남해군고현면,3496,1906,1.83,1632,1864,0.88
3741,4884038000,경상남도남해군설천면,2792,1587,1.76,1318,1474,0.89
3742,4884039000,경상남도남해군창선면,5475,3066,1.79,2598,2877,0.9
3743,4885000000,경상남도하동군,43449,23769,1.83,21696,21753,1.0
3744,4885025000,경상남도하동군하동읍,9724,4877,1.99,4793,4931,0.97
3745,4885031000,경상남도하동군화개면,3039,1705,1.78,1533,1506,1.02
3746,4885032000,경상남도하동군악양면,3493,1991,1.75,1733,1760,0.98
3747,4885033000,경상남도하동군적량면,1914,1092,1.75,944,970,0.97
3748,4885034000,경상남도하동군횡천면,1820,1037,1.76,893,927,0.96
3749,4885035000,경상남도하동군고전면,2186,1221,1.79,1074,1112,0.97
3750,4885036000,경상남도하동군금남면,3384,1979,1.71,1725,1659,1.04
3751,4885037000,경상남도하동군진교면,5911,3021,1.96,2929,2982,0.98
3752,4885038000,경상남도하동군양보면,1710,1006,1.7,832,878,0.95
3753,4885039000,경상남도하동군북천면,1681,976,1.72,821,860,0.95
3754,4885040000,경상남도하동군청암면,1425,839,1.7,742,683,1.09
3755,4885041000,경상남도하동군옥종면,4206,2353,1.79,2127,2079,1.02
3756,4885042000,경상남도하동군금성면,2956,1672,1.77,1550,1406,1.1
3757,4886000000,경상남도산청군,34360,19600,1.75,16931,17429,0.97
3758,4886025000,경상남도산청군산청읍,6736,3632,1.85,3276,3460,0.95
3759,4886031000,경상남도산청군차황면,1412,873,1.62,698,714,0.98
3760,4886032000,경상남도산청군오부면,1054,631,1.67,509,545,0.93
3761,4886033000,경상남도산청군생초면,1986,1220,1.63,960,1026,0.94
3762,4886034000,경상남도산청군금서면,2870,1676,1.71,1410,1460,0.97
3763,4886035000,경상남도산청군삼장면,1812,1062,1.71,889,923,0.96
3764,4886036000,경상남도산청군시천면,4093,2315,1.77,2045,2048,1.0
3765,4886037000,경상남도산청군단성면,5628,3357,1.68,2836,2792,1.02
3766,4886038000,경상남도산청군신안면,5557,2827,1.97,2726,2831,0.96
3767,4886039000,경상남도산청군생비량면,1155,753,1.53,557,598,0.93
3768,4886040000,경상남도산청군신등면,2057,1254,1.64,1025,1032,0.99
3769,4887000000,경상남도함양군,38310,20840,1.84,18531,19779,0.94
3770,4887025000,경상남도함양군함양읍,18109,8698,2.08,8809,9300,0.95
3771,4887031000,경상남도함양군마천면,2140,1341,1.6,1026,1114,0.92
3772,4887032000,경상남도함양군휴천면,1557,1011,1.54,774,783,0.99
3773,4887033000,경상남도함양군유림면,1590,998,1.59,753,837,0.9
3774,4887034000,경상남도함양군수동면,2380,1396,1.7,1165,1215,0.96
3775,4887035000,경상남도함양군지곡면,2050,1178,1.74,991,1059,0.94
3776,4887036000,경상남도함양군안의면,4434,2615,1.7,2091,2343,0.89
3777,4887037000,경상남도함양군서하면,1383,846,1.63,656,727,0.9
3778,4887038000,경상남도함양군서상면,1812,1094,1.66,854,958,0.89
3779,4887039000,경상남도함양군백전면,1557,933,1.67,785,772,1.02
3780,4887040000,경상남도함양군병곡면,1298,730,1.78,627,671,0.93
3781,4888000000,경상남도거창군,61073,30564,2.0,29955,31118,0.96
3782,4888025000,경상남도거창군거창읍,40541,18544,2.19,19985,20556,0.97
3783,4888031000,경상남도거창군주상면,1540,882,1.75,772,768,1.01
3784,4888032000,경상남도거창군웅양면,1862,1027,1.81,915,947,0.97
3785,4888033000,경상남도거창군고제면,1389,829,1.68,700,689,1.02
3786,4888034000,경상남도거창군북상면,1523,923,1.65,753,770,0.98
3787,4888035000,경상남도거창군위천면,1973,1131,1.74,926,1047,0.88
3788,4888036000,경상남도거창군마리면,1980,1176,1.68,949,1031,0.92
3789,4888037000,경상남도거창군남상면,2331,1325,1.76,1146,1185,0.97
3790,4888038000,경상남도거창군남하면,1396,831,1.68,654,742,0.88
3791,4888039000,경상남도거창군신원면,1492,920,1.62,723,769,0.94
3792,4888040000,경상남도거창군가조면,3686,2138,1.72,1772,1914,0.93
3793,4888041000,경상남도거창군가북면,1360,838,1.62,660,700,0.94
3794,4889000000,경상남도합천군,42935,24213,1.77,20765,22170,0.94
3795,4889025000,경상남도합천군합천읍,11108,5168,2.15,5423,5685,0.95
3796,4889031000,경상남도합천군봉산면,1402,888,1.58,689,713,0.97
3797,4889032000,경상남도합천군묘산면,1564,932,1.68,754,810,0.93
3798,4889033000,경상남도합천군가야면,4150,2306,1.8,2019,2131,0.95
3799,4889034000,경상남도합천군야로면,2359,1401,1.68,1119,1240,0.9
3800,4889035000,경상남도합천군율곡면,2236,1335,1.67,1134,1102,1.03
3801,4889036000,경상남도합천군초계면,2379,1362,1.75,1143,1236,0.92
3802,4889037000,경상남도합천군쌍책면,1225,778,1.57,587,638,0.92
3803,4889038000,경상남도합천군덕곡면,845,528,1.6,420,425,0.99
3804,4889039000,경상남도합천군청덕면,1607,1065,1.51,779,828,0.94
3805,4889040000,경상남도합천군적중면,1383,821,1.68,645,738,0.87
3806,4889041000,경상남도합천군대양면,1828,1056,1.73,901,927,0.97
3807,4889042000,경상남도합천군쌍백면,1743,1125,1.55,826,917,0.9
3808,4889043000,경상남도합천군삼가면,3168,1867,1.7,1457,1711,0.85
3809,4889044000,경상남도합천군가회면,1717,1040,1.65,821,896,0.92
3810,4889045000,경상남도합천군대병면,1990,1199,1.66,950,1040,0.91
3811,4889046000,경상남도합천군용주면,2231,1342,1.66,1098,1133,0.97
3812,5000000000,제주특별자치도,676759,307529,2.2,339177,337582,1.0
3813,5011000000,제주특별자치도제주시,493096,219978,2.24,246494,246602,1.0
3814,5011025000,제주특별자치도제주시한림읍,21248,10641,2.0,10908,10340,1.05
3815,5011025300,제주특별자치도제주시애월읍,37532,17276,2.17,19209,18323,1.05
3816,5011025600,제주특별자치도제주시구좌읍,15397,7945,1.94,7898,7499,1.05
3817,5011025900,제주특별자치도제주시조천읍,25538,11654,2.19,13060,12478,1.05
3818,5011031000,제주특별자치도제주시한경면,9295,5009,1.86,4667,4628,1.01
3819,5011032000,제주특별자치도제주시추자면,1586,947,1.67,847,739,1.15
3820,5011033000,제주특별자치도제주시우도면,1692,920,1.84,892,800,1.12
3821,5011051000,제주특별자치도제주시일도1동,2406,1408,1.71,1270,1136,1.12
3822,5011052000,제주특별자치도제주시일도2동,32441,13402,2.42,15974,16467,0.97
3823,5011053000,제주특별자치도제주시이도1동,7523,3815,1.97,3730,3793,0.98
3824,5011054000,제주특별자치도제주시이도2동,49496,21143,2.34,24220,25276,0.96
3825,5011055000,제주특별자치도제주시삼도1동,13454,6050,2.22,6612,6842,0.97
3826,5011056000,제주특별자치도제주시삼도2동,7955,4134,1.92,4122,3833,1.08
3827,5011057000,제주특별자치도제주시용담1동,6839,3420,2.0,3519,3320,1.06
3828,5011058000,제주특별자치도제주시용담2동,14430,6461,2.23,7327,7103,1.03
3829,5011059000,제주특별자치도제주시건입동,8854,4100,2.16,4508,4346,1.04
3830,5011060000,제주특별자치도제주시화북동,24006,9655,2.49,11913,12093,0.99
3831,5011061000,제주특별자치도제주시삼양동,25876,9892,2.62,12980,12896,1.01
3832,5011062000,제주특별자치도제주시봉개동,5263,2387,2.2,2719,2544,1.07
3833,5011063000,제주특별자치도제주시아라동,38622,16278,2.37,19043,19579,0.97
3834,5011064000,제주특별자치도제주시오라동,15896,6251,2.54,8022,7874,1.02
3835,5011065000,제주특별자치도제주시연동,42265,21571,1.96,20675,21590,0.96
3836,5011066000,제주특별자치도제주시노형동,55420,23321,2.38,27156,28264,0.96
3837,5011067000,제주특별자치도제주시외도동,22278,8798,2.53,11127,11151,1.0
3838,5011068000,제주특별자치도제주시이호동,4458,1935,2.3,2336,2122,1.1
3839,5011069000,제주특별자치도제주시도두동,3326,1565,2.13,1760,1566,1.12
3840,5013000000,제주특별자치도서귀포시,183663,87551,2.1,92683,90980,1.02
3841,5013025000,제주특별자치도서귀포시대정읍,22197,10691,2.08,10767,11430,0.94
3842,5013025300,제주특별자치도서귀포시남원읍,18664,8769,2.13,9654,9010,1.07
3843,5013025900,제주특별자치도서귀포시성산읍,15500,8210,1.89,8135,7365,1.1
3844,5013031000,제주특별자치도서귀포시안덕면,12228,6371,1.92,6343,5885,1.08
3845,5013032000,제주특별자치도서귀포시표선면,12393,6217,1.99,6326,6067,1.04
3846,5013051000,제주특별자치도서귀포시송산동,3980,1949,2.04,2111,1869,1.13
3847,5013052000,제주특별자치도서귀포시정방동,2136,1311,1.63,1083,1053,1.03
3848,5013053000,제주특별자치도서귀포시중앙동,3301,1918,1.72,1572,1729,0.91
3849,5013054000,제주특별자치도서귀포시천지동,3439,1975,1.74,1731,1708,1.01
3850,5013055000,제주특별자치도서귀포시효돈동,5328,2373,2.25,2684,2644,1.02
3851,5013056000,제주특별자치도서귀포시영천동,5203,2484,2.09,2634,2569,1.03
3852,5013057000,제주특별자치도서귀포시동홍동,23201,9637,2.41,11281,11920,0.95
3853,5013058000,제주특별자치도서귀포시서홍동,11072,4545,2.44,5478,5594,0.98
3854,5013059000,제주특별자치도서귀포시대륜동,15325,6835,2.24,7771,7554,1.03
3855,5013060000,제주특별자치도서귀포시대천동,13824,6459,2.14,7030,6794,1.03
3856,5013061000,제주특별자치도서귀포시중문동,11943,5783,2.07,6070,5873,1.03
3857,5013062000,제주특별자치도서귀포시예래동,3929,2024,1.94,2013,1916,1.05
